Saison start;Saison ende;Rang;Verein;Spiele;Punkte;Tordifferenz;Tore;Gegentore;Siege;Unentschieden;Niederlagen;Punkte_3;Punkte_2;Stadt;Breitengrad;Längengrad;Total Spiele;Total effektive Punkte;Totale Tordifferenz;Totale Tore;Totale Gegentore;Totale Siege;Totale Unentschieden;Totale Niederlagen;Totale Punkte_3;Totale Punkte_2
1963;1964;1;1. FC Köln;30;45;38;78;40;17;11;2;62;45;Köln;50.9333∘N;6.9500∘O;30;45;38;78;40;17;11;2;62;45
1963;1964;2;MSV Duisburg;30;39;24;60;36;13;13;4;52;39;Duisburg;51.4333∘N;6.7667∘O;30;39;24;60;36;13;13;4;52;39
1963;1964;3;Eintracht Frankfurt;30;39;24;65;41;16;7;7;55;39;Frankfurt am Main;50.1109∘N;8.6821∘O;30;39;24;65;41;16;7;7;55;39
1963;1964;4;Borussia Dortmund;30;33;16;73;57;14;5;11;47;33;Dortmund;51.5136∘N;7.4653∘O;30;33;16;73;57;14;5;11;47;33
1963;1964;5;VfB Stuttgart;30;33;8;48;40;13;7;10;46;33;Stuttgart;48.7833∘N;9.1833∘O;30;33;8;48;40;13;7;10;46;33
1963;1964;6;Hamburger SV;30;32;9;69;60;11;10;9;43;32;Hamburg;53.5511∘N;9.9937∘O;30;32;9;69;60;11;10;9;43;32
1963;1964;7;1860 München;30;31;16;66;50;11;9;10;42;31;München;48.1372∘N;11.5755∘O;30;31;16;66;50;11;9;10;42;31
1963;1964;8;Schalke 04;30;29;-2;51;53;12;5;13;41;29;Gelsenkirchen;51.5167∘N;7.0500∘O;30;29;-2;51;53;12;5;13;41;29
1963;1964;9;1. FC Nürnberg;30;29;-11;45;56;11;7;12;40;29;Nürnberg;49.4521∘N;11.0767∘O;30;29;-11;45;56;11;7;12;40;29
1963;1964;10;Werder Bremen;30;28;-9;53;62;10;8;12;38;28;Bremen;53.0736∘N;8.8064∘O;30;28;-9;53;62;10;8;12;38;28
1963;1964;11;Eintracht Braunschweig;30;28;-13;36;49;11;6;13;39;28;Braunschweig;52.2667∘N;10.5167∘O;30;28;-13;36;49;11;6;13;39;28
1963;1964;12;1. FC Kaiserslautern;30;26;-21;48;69;10;6;14;36;26;Kaiserslautern;49.4444∘N;7.7778∘O;30;26;-21;48;69;10;6;14;36;26
1963;1964;13;Karlsruher SC;30;24;-13;42;55;8;8;14;32;24;Karlsruhe;49.0069∘N;8.4037∘O;30;24;-13;42;55;8;8;14;32;24
1963;1964;14;Hertha BSC Berlin;30;24;-20;45;65;9;6;15;33;24;Berlin;52.5200∘N;13.4050∘O;30;24;-20;45;65;9;6;15;33;24
1963;1964;15;Preußen Münster;30;23;-18;34;52;7;9;14;30;23;Münster;51.9607∘N;7.6261∘O;30;23;-18;34;52;7;9;14;30;23
1963;1964;16;1. FC Saarbrücken;30;17;-28;44;72;6;5;19;23;17;Saarbrücken;49.2333∘N;7.0000∘O;30;17;-28;44;72;6;5;19;23;17
1964;1965;1;Werder Bremen;30;41;25;54;29;15;11;4;56;41;Bremen;53.0736∘N;8.8064∘O;60;69;16;107;91;25;19;16;94;69
1964;1965;2;1. FC Köln;30;38;21;66;45;14;10;6;52;38;Köln;50.9333∘N;6.9500∘O;60;83;59;144;85;31;21;8;114;83
1964;1965;3;Borussia Dortmund;30;36;19;67;48;15;6;9;51;36;Dortmund;51.5136∘N;7.4653∘O;60;69;35;140;105;29;11;20;98;69
1964;1965;4;1860 München;30;35;20;70;50;14;7;9;49;35;München;48.1372∘N;11.5755∘O;60;66;36;136;100;25;16;19;91;66
1964;1965;5;Hannover 96;30;33;6;48;42;13;7;10;46;33;Hannover;52.3759∘N;9.7320∘O;30;33;6;48;42;13;7;10;46;33
1964;1965;6;1. FC Nürnberg;30;32;6;44;38;11;10;9;43;32;Nürnberg;49.4521∘N;11.0767∘O;60;61;-5;89;94;22;17;21;83;61
1964;1965;7;MSV Duisburg;30;32;-2;46;48;12;8;10;44;32;Duisburg;51.4333∘N;6.7667∘O;60;71;22;106;84;25;21;14;96;71
1964;1965;8;Eintracht Frankfurt;30;29;-8;50;58;11;7;12;40;29;Frankfurt am Main;50.1109∘N;8.6821∘O;60;68;16;115;99;27;14;19;95;68
1964;1965;9;Eintracht Braunschweig;30;28;-5;42;47;10;8;12;38;28;Braunschweig;52.2667∘N;10.5167∘O;60;56;-18;78;96;21;14;25;77;56
1964;1965;10;Borussia Neunkirchen;30;27;-4;44;48;9;9;12;36;27;Neunkirchen;47.7819∘N;7.8647∘O;30;27;-4;44;48;9;9;12;36;27
1964;1965;11;Hamburger SV;30;27;-10;46;56;11;5;14;38;27;Hamburg;53.5511∘N;9.9937∘O;60;59;-1;115;116;22;15;23;81;59
1964;1965;12;VfB Stuttgart;30;26;-4;46;50;9;8;13;35;26;Stuttgart;48.7833∘N;9.1833∘O;60;59;4;94;90;22;15;23;81;59
1964;1965;13;1. FC Kaiserslautern;30;25;-12;41;53;11;3;16;36;25;Kaiserslautern;49.4444∘N;7.7778∘O;60;51;-33;89;122;21;9;30;72;51
1964;1965;14;Hertha BSC Berlin;30;25;-22;40;62;7;11;12;32;25;Berlin;52.5200∘N;13.4050∘O;60;49;-42;85;127;16;17;27;65;49
1964;1965;15;Karlsruher SC;30;24;-15;47;62;9;6;15;33;24;Karlsruhe;49.0069∘N;8.4037∘O;60;48;-28;89;117;17;14;29;65;48
1964;1965;16;Schalke 04;30;22;-15;45;60;7;8;15;29;22;Gelsenkirchen;51.5167∘N;7.0500∘O;60;51;-17;96;113;19;13;28;70;51
1965;1966;1;1860 München;34;50;40;80;40;20;10;4;70;50;München;48.1372∘N;11.5755∘O;94;116;76;216;140;45;26;23;161;116
1965;1966;2;Borussia Dortmund;34;47;34;70;36;19;9;6;66;47;Dortmund;51.5136∘N;7.4653∘O;94;116;69;210;141;48;20;26;164;116
1965;1966;3;Bayern München;34;47;33;71;38;20;7;7;67;47;München;48.1372∘N;11.5755∘O;34;47;33;71;38;20;7;7;67;47
1965;1966;4;Werder Bremen;34;45;36;76;40;21;3;10;66;45;Bremen;53.0736∘N;8.8064∘O;94;114;52;183;131;46;22;26;160;114
1965;1966;5;1. FC Köln;34;44;33;74;41;19;6;9;63;44;Köln;50.9333∘N;6.9500∘O;94;127;92;218;126;50;27;17;177;127
1965;1966;6;1. FC Nürnberg;34;39;11;54;43;14;11;9;53;39;Nürnberg;49.4521∘N;11.0767∘O;94;100;6;143;137;36;28;30;136;100
1965;1966;7;Eintracht Frankfurt;34;38;18;64;46;16;6;12;54;38;Frankfurt am Main;50.1109∘N;8.6821∘O;94;106;34;179;145;43;20;31;149;106
1965;1966;8;MSV Duisburg;34;36;22;70;48;14;8;12;50;36;Duisburg;51.4333∘N;6.7667∘O;94;107;44;176;132;39;29;26;146;107
1965;1966;9;Hamburger SV;34;34;12;64;52;13;8;13;47;34;Hamburg;53.5511∘N;9.9937∘O;94;93;11;179;168;35;23;36;128;93
1965;1966;10;Eintracht Braunschweig;34;34;0;49;49;11;12;11;45;34;Braunschweig;52.2667∘N;10.5167∘O;94;90;-18;127;145;32;26;36;122;90
1965;1966;11;VfB Stuttgart;34;32;-6;42;48;13;6;15;45;32;Stuttgart;48.7833∘N;9.1833∘O;94;91;-2;136;138;35;21;38;126;91
1965;1966;12;Hannover 96;34;30;2;59;57;11;8;15;41;30;Hannover;52.3759∘N;9.7320∘O;64;63;8;107;99;24;15;25;87;63
1965;1966;13;Bor. Mönchengladbach;34;29;-11;57;68;9;11;14;38;29;Mönchengladbach;51.1965∘N;6.4385∘O;34;29;-11;57;68;9;11;14;38;29
1965;1966;14;Schalke 04;34;27;-22;33;55;10;7;17;37;27;Gelsenkirchen;51.5167∘N;7.0500∘O;94;78;-39;129;168;29;20;45;107;78
1965;1966;15;1. FC Kaiserslautern;34;26;-23;42;65;8;10;16;34;26;Kaiserslautern;49.4444∘N;7.7778∘O;94;77;-56;131;187;29;19;46;106;77
1965;1966;16;Karlsruher SC;34;24;-36;35;71;9;6;19;33;24;Karlsruhe;49.0069∘N;8.4037∘O;94;72;-64;124;188;26;20;48;98;72
1965;1966;17;Borussia Neunkirchen;34;22;-50;32;82;9;4;21;31;22;Neunkirchen;47.7819∘N;7.8647∘O;64;49;-54;76;130;18;13;33;67;49
1965;1966;18;Tasmania Berlin;34;8;-93;15;108;2;4;28;10;8;Berlin;52.5200∘N;13.4050∘O;34;8;-93;15;108;2;4;28;10;8
1966;1967;1;Eintracht Braunschweig;34;43;22;49;27;17;9;8;60;43;Braunschweig;52.2667∘N;10.5167∘O;128;133;4;176;172;49;35;44;182;133
1966;1967;2;1860 München;34;41;13;60;47;17;7;10;58;41;München;48.1372∘N;11.5755∘O;128;157;89;276;187;62;33;33;219;157
1966;1967;3;Borussia Dortmund;34;39;29;70;41;15;9;10;54;39;Dortmund;51.5136∘N;7.4653∘O;128;155;98;280;182;63;29;36;218;155
1966;1967;4;Eintracht Frankfurt;34;39;17;66;49;15;9;10;54;39;Frankfurt am Main;50.1109∘N;8.6821∘O;128;145;51;245;194;58;29;41;203;145
1966;1967;5;1. FC Kaiserslautern;34;38;1;43;42;13;12;9;51;38;Kaiserslautern;49.4444∘N;7.7778∘O;128;115;-55;174;229;42;31;55;157;115
1966;1967;6;Bayern München;34;37;15;62;47;16;5;13;53;37;München;48.1372∘N;11.5755∘O;68;84;48;133;85;36;12;20;120;84
1966;1967;7;1. FC Köln;34;37;0;48;48;14;9;11;51;37;Köln;50.9333∘N;6.9500∘O;128;164;92;266;174;64;36;28;228;164
1966;1967;8;Bor. Mönchengladbach;34;34;21;70;49;12;10;12;46;34;Mönchengladbach;51.1965∘N;6.4385∘O;68;63;10;127;117;21;21;26;84;63
1966;1967;9;Hannover 96;34;34;-6;40;46;13;8;13;47;34;Hannover;52.3759∘N;9.7320∘O;98;97;2;147;145;37;23;38;134;97
1966;1967;10;1. FC Nürnberg;34;34;-7;43;50;12;10;12;46;34;Nürnberg;49.4521∘N;11.0767∘O;128;134;-1;186;187;48;38;42;182;134
1966;1967;11;MSV Duisburg;34;33;-2;40;42;10;13;11;43;33;Duisburg;51.4333∘N;6.7667∘O;128;140;42;216;174;49;42;37;189;140
1966;1967;12;VfB Stuttgart;34;33;-6;48;54;10;13;11;43;33;Stuttgart;48.7833∘N;9.1833∘O;128;124;-8;184;192;45;34;49;169;124
1966;1967;13;Karlsruher SC;34;31;-8;54;62;11;9;14;42;31;Karlsruhe;49.0069∘N;8.4037∘O;128;103;-72;178;250;37;29;62;140;103
1966;1967;14;Hamburger SV;34;30;-16;37;53;10;10;14;40;30;Hamburg;53.5511∘N;9.9937∘O;128;123;-5;216;221;45;33;50;168;123
1966;1967;15;Schalke 04;34;30;-26;37;63;12;6;16;42;30;Gelsenkirchen;51.5167∘N;7.0500∘O;128;108;-65;166;231;41;26;61;149;108
1966;1967;16;Werder Bremen;34;29;-7;49;56;10;9;15;39;29;Bremen;53.0736∘N;8.8064∘O;128;143;45;232;187;56;31;41;199;143
1966;1967;17;RW Essen;34;25;-18;35;53;6;13;15;31;25;Essen;51.4556∘N;7.0125∘O;34;25;-18;35;53;6;13;15;31;25
1966;1967;18;Fortuna Düsseldorf;34;25;-22;44;66;9;7;18;34;25;Düsseldorf;51.2217∘N;6.7761∘O;34;25;-22;44;66;9;7;18;34;25
1967;1968;1;1. FC Nürnberg;34;47;34;71;37;19;9;6;66;47;Nürnberg;49.4521∘N;11.0767∘O;162;181;33;257;224;67;47;48;248;181
1967;1968;2;Werder Bremen;34;44;17;68;51;18;8;8;62;44;Bremen;53.0736∘N;8.8064∘O;162;187;62;300;238;74;39;49;261;187
1967;1968;3;Bor. Mönchengladbach;34;42;32;77;45;15;12;7;57;42;Mönchengladbach;51.1965∘N;6.4385∘O;102;105;42;204;162;36;33;33;141;105
1967;1968;4;1. FC Köln;34;38;16;68;52;17;4;13;55;38;Köln;50.9333∘N;6.9500∘O;162;202;108;334;226;81;40;41;283;202
1967;1968;5;Bayern München;34;38;10;68;58;16;6;12;54;38;München;48.1372∘N;11.5755∘O;102;122;58;201;143;52;18;32;174;122
1967;1968;6;Eintracht Frankfurt;34;38;7;58;51;15;8;11;53;38;Frankfurt am Main;50.1109∘N;8.6821∘O;162;183;58;303;245;73;37;52;256;183
1967;1968;7;MSV Duisburg;34;36;11;69;58;13;10;11;49;36;Duisburg;51.4333∘N;6.7667∘O;162;176;53;285;232;62;52;48;238;176
1967;1968;8;VfB Stuttgart;34;35;11;65;54;14;7;13;49;35;Stuttgart;48.7833∘N;9.1833∘O;162;159;3;249;246;59;41;62;218;159
1967;1968;9;Eintracht Braunschweig;34;35;-2;37;39;15;5;14;50;35;Braunschweig;52.2667∘N;10.5167∘O;162;168;2;213;211;64;40;58;232;168
1967;1968;10;Hannover 96;34;34;-4;48;52;12;10;12;46;34;Hannover;52.3759∘N;9.7320∘O;132;131;-2;195;197;49;33;50;180;131
1967;1968;11;Alemannia Aachen;34;34;-14;52;66;13;8;13;47;34;Aachen;50.7753∘N;6.0839∘O;34;34;-14;52;66;13;8;13;47;34
1967;1968;12;1860 München;34;33;16;55;39;11;11;12;44;33;München;48.1372∘N;11.5755∘O;162;190;105;331;226;73;44;45;263;190
1967;1968;13;Hamburger SV;34;33;-3;51;54;11;11;12;44;33;Hamburg;53.5511∘N;9.9937∘O;162;156;-8;267;275;56;44;62;212;156
1967;1968;14;Borussia Dortmund;34;31;1;60;59;12;7;15;43;31;Dortmund;51.5136∘N;7.4653∘O;162;186;99;340;241;75;36;51;261;186
1967;1968;15;Schalke 04;34;30;-6;42;48;11;8;15;41;30;Gelsenkirchen;51.5167∘N;7.0500∘O;162;138;-71;208;279;52;34;76;190;138
1967;1968;16;1. FC Kaiserslautern;34;28;-28;39;67;8;12;14;36;28;Kaiserslautern;49.4444∘N;7.7778∘O;162;143;-83;213;296;50;43;69;193;143
1967;1968;17;Borussia Neunkirchen;34;19;-60;33;93;7;5;22;26;19;Neunkirchen;47.7819∘N;7.8647∘O;98;68;-114;109;223;25;18;55;93;68
1967;1968;18;Karlsruher SC;34;17;-38;32;70;6;5;23;23;17;Karlsruhe;49.0069∘N;8.4037∘O;162;120;-110;210;320;43;34;85;163;120
1968;1969;1;Bayern München;34;46;30;61;31;18;10;6;64;46;München;48.1372∘N;11.5755∘O;136;168;88;262;174;70;28;38;238;168
1968;1969;2;Alemannia Aachen;34;38;6;57;51;16;6;12;54;38;Aachen;50.7753∘N;6.0839∘O;68;72;-8;109;117;29;14;25;101;72
1968;1969;3;Bor. Mönchengladbach;34;37;15;61;46;13;11;10;50;37;Mönchengladbach;51.1965∘N;6.4385∘O;136;142;57;265;208;49;44;43;191;142
1968;1969;4;Eintracht Braunschweig;34;37;3;46;43;13;11;10;50;37;Braunschweig;52.2667∘N;10.5167∘O;196;205;5;259;254;77;51;68;282;205
1968;1969;5;VfB Stuttgart;34;36;6;60;54;14;8;12;50;36;Stuttgart;48.7833∘N;9.1833∘O;196;195;9;309;300;73;49;74;268;195
1968;1969;6;Hamburger SV;34;36;0;55;55;13;10;11;49;36;Hamburg;53.5511∘N;9.9937∘O;196;192;-8;322;330;69;54;73;261;192
1968;1969;7;Schalke 04;34;35;5;45;40;14;7;13;49;35;Gelsenkirchen;51.5167∘N;7.0500∘O;196;173;-66;253;319;66;41;89;239;173
1968;1969;8;Eintracht Frankfurt;34;34;3;46;43;13;8;13;47;34;Frankfurt am Main;50.1109∘N;8.6821∘O;196;217;61;349;288;86;45;65;303;217
1968;1969;9;Werder Bremen;34;34;0;59;59;14;6;14;48;34;Bremen;53.0736∘N;8.8064∘O;196;221;62;359;297;88;45;63;309;221
1968;1969;10;1860 München;34;34;-15;44;59;15;4;15;49;34;München;48.1372∘N;11.5755∘O;196;224;90;375;285;88;48;60;312;224
1968;1969;11;Hannover 96;34;32;2;47;45;9;14;11;41;32;Hannover;52.3759∘N;9.7320∘O;166;163;0;242;242;58;47;61;221;163
1968;1969;12;MSV Duisburg;34;32;-4;33;37;8;16;10;40;32;Duisburg;51.4333∘N;6.7667∘O;196;208;49;318;269;70;68;58;278;208
1968;1969;13;Hertha BSC Berlin;34;32;-8;31;39;12;8;14;44;32;Berlin;52.5200∘N;13.4050∘O;94;81;-50;116;166;28;25;41;109;81
1968;1969;14;1. FC Köln;34;32;-9;47;56;13;6;15;45;32;Köln;50.9333∘N;6.9500∘O;196;234;99;381;282;94;46;56;328;234
1968;1969;15;1. FC Kaiserslautern;34;30;-2;45;47;12;6;16;42;30;Kaiserslautern;49.4444∘N;7.7778∘O;196;173;-85;258;343;62;49;85;235;173
1968;1969;16;Borussia Dortmund;34;30;-5;49;54;11;8;15;41;30;Dortmund;51.5136∘N;7.4653∘O;196;216;94;389;295;86;44;66;302;216
1968;1969;17;1. FC Nürnberg;34;29;-10;45;55;9;11;14;38;29;Nürnberg;49.4521∘N;11.0767∘O;196;210;23;302;279;76;58;62;286;210
1968;1969;18;Kickers Offenbach;34;28;-17;42;59;10;8;16;38;28;Offenbach am Main;50.0898∘N;8.7618∘O;34;28;-17;42;59;10;8;16;38;28
1969;1970;1;Bor. Mönchengladbach;34;51;42;71;29;23;5;6;74;51;Mönchengladbach;51.1965∘N;6.4385∘O;170;193;99;336;237;72;49;49;265;193
1969;1970;2;Bayern München;34;47;51;88;37;21;5;8;68;47;München;48.1372∘N;11.5755∘O;170;215;139;350;211;91;33;46;306;215
1969;1970;3;Hertha BSC Berlin;34;45;26;67;41;20;5;9;65;45;Berlin;52.5200∘N;13.4050∘O;128;126;-24;183;207;48;30;50;174;126
1969;1970;4;1. FC Köln;34;43;45;83;38;20;3;11;63;43;Köln;50.9333∘N;6.9500∘O;230;277;144;464;320;114;49;67;391;277
1969;1970;5;Borussia Dortmund;34;36;-7;60;67;14;8;12;50;36;Dortmund;51.5136∘N;7.4653∘O;230;252;87;449;362;100;52;78;352;252
1969;1970;6;Hamburger SV;34;35;3;57;54;12;11;11;47;35;Hamburg;53.5511∘N;9.9937∘O;230;227;-5;379;384;81;65;84;308;227
1969;1970;7;VfB Stuttgart;34;35;-3;59;62;14;7;13;49;35;Stuttgart;48.7833∘N;9.1833∘O;230;230;6;368;362;87;56;87;317;230
1969;1970;8;Eintracht Frankfurt;34;34;0;54;54;12;10;12;46;34;Frankfurt am Main;50.1109∘N;8.6821∘O;230;251;61;403;342;98;55;77;349;251
1969;1970;9;Schalke 04;34;34;-11;43;54;11;12;11;45;34;Gelsenkirchen;51.5167∘N;7.0500∘O;230;207;-77;296;373;77;53;100;284;207
1969;1970;10;1. FC Kaiserslautern;34;32;-11;44;55;10;12;12;42;32;Kaiserslautern;49.4444∘N;7.7778∘O;230;205;-96;302;398;72;61;97;277;205
1969;1970;11;Werder Bremen;34;31;-9;38;47;10;11;13;41;31;Bremen;53.0736∘N;8.8064∘O;230;252;53;397;344;98;56;76;350;252
1969;1970;12;RW Essen;34;31;-13;41;54;8;15;11;39;31;Essen;51.4556∘N;7.0125∘O;68;56;-31;76;107;14;28;26;70;56
1969;1970;13;Hannover 96;34;30;-12;49;61;11;8;15;41;30;Hannover;52.3759∘N;9.7320∘O;200;193;-12;291;303;69;55;76;262;193
1969;1970;14;RW Oberhausen;34;29;-12;50;62;11;7;16;40;29;Oberhausen;51.4667∘N;6.8667∘O;34;29;-12;50;62;11;7;16;40;29
1969;1970;15;MSV Duisburg;34;29;-13;35;48;9;11;14;38;29;Duisburg;51.4333∘N;6.7667∘O;230;237;36;353;317;79;79;72;316;237
1969;1970;16;Eintracht Braunschweig;34;28;-9;40;49;9;10;15;37;28;Braunschweig;52.2667∘N;10.5167∘O;230;233;-4;299;303;86;61;83;319;233
1969;1970;17;1860 München;34;25;-15;41;56;9;7;18;34;25;München;48.1372∘N;11.5755∘O;230;249;75;416;341;97;55;78;346;249
1969;1970;18;Alemannia Aachen;34;17;-52;31;83;5;7;22;22;17;Aachen;50.7753∘N;6.0839∘O;102;89;-60;140;200;34;21;47;123;89
1970;1971;1;Bor. Mönchengladbach;34;50;42;77;35;20;10;4;70;50;Mönchengladbach;51.1965∘N;6.4385∘O;204;243;141;413;272;92;59;53;335;243
1970;1971;2;Bayern München;34;48;38;74;36;19;10;5;67;48;München;48.1372∘N;11.5755∘O;204;263;177;424;247;110;43;51;373;263
1970;1971;3;Hertha BSC Berlin;34;41;18;61;43;16;9;9;57;41;Berlin;52.5200∘N;13.4050∘O;162;167;-6;244;250;64;39;59;231;167
1970;1971;4;Eintracht Braunschweig;34;39;12;52;40;16;7;11;55;39;Braunschweig;52.2667∘N;10.5167∘O;264;272;8;351;343;102;68;94;374;272
1970;1971;5;Hamburger SV;34;37;-9;54;63;13;11;10;50;37;Hamburg;53.5511∘N;9.9937∘O;264;264;-14;433;447;94;76;94;358;264
1970;1971;6;Schalke 04;34;36;4;44;40;15;6;13;51;36;Gelsenkirchen;51.5167∘N;7.0500∘O;264;243;-73;340;413;92;59;113;335;243
1970;1971;7;MSV Duisburg;34;35;-4;43;47;12;11;11;47;35;Duisburg;51.4333∘N;6.7667∘O;264;272;32;396;364;91;90;83;363;272
1970;1971;8;1. FC Kaiserslautern;34;34;-3;54;57;15;4;15;49;34;Kaiserslautern;49.4444∘N;7.7778∘O;264;239;-99;356;455;87;65;112;326;239
1970;1971;9;Hannover 96;34;33;4;53;49;12;9;13;45;33;Hannover;52.3759∘N;9.7320∘O;234;226;-8;344;352;81;64;89;307;226
1970;1971;10;Werder Bremen;34;33;1;41;40;11;11;12;44;33;Bremen;53.0736∘N;8.8064∘O;264;285;54;438;384;109;67;88;394;285
1970;1971;11;1. FC Köln;34;33;-10;46;56;11;11;12;44;33;Köln;50.9333∘N;6.9500∘O;264;310;134;510;376;125;60;79;435;310
1970;1971;12;VfB Stuttgart;34;30;0;49;49;11;8;15;41;30;Stuttgart;48.7833∘N;9.1833∘O;264;260;6;417;411;98;64;102;358;260
1970;1971;13;Borussia Dortmund;34;29;-6;54;60;10;9;15;39;29;Dortmund;51.5136∘N;7.4653∘O;264;281;81;503;422;110;61;93;391;281
1970;1971;14;Arminia Bielefeld;34;29;-19;34;53;12;5;17;41;29;Bielefeld;52.0211∘N;8.5342∘O;34;29;-19;34;53;12;5;17;41;29
1970;1971;15;Eintracht Frankfurt;34;28;-17;39;56;11;6;17;39;28;Frankfurt am Main;50.1109∘N;8.6821∘O;264;279;44;442;398;109;61;94;388;279
1970;1971;16;RW Oberhausen;34;27;-15;54;69;9;9;16;36;27;Oberhausen;51.4667∘N;6.8667∘O;68;56;-27;104;131;20;16;32;76;56
1970;1971;17;Kickers Offenbach;34;27;-16;49;65;9;9;16;36;27;Offenbach am Main;50.0898∘N;8.7618∘O;68;55;-33;91;124;19;17;32;74;55
1970;1971;18;RW Essen;34;23;-20;48;68;7;9;18;30;23;Essen;51.4556∘N;7.0125∘O;102;79;-51;124;175;21;37;44;100;79
1971;1972;1;Bayern München;34;55;63;101;38;24;7;3;79;55;München;48.1372∘N;11.5755∘O;238;318;240;525;285;134;50;54;452;318
1971;1972;2;Schalke 04;34;52;41;76;35;24;4;6;76;52;Gelsenkirchen;51.5167∘N;7.0500∘O;298;295;-32;416;448;116;63;119;411;295
1971;1972;3;Bor. Mönchengladbach;34;43;42;82;40;18;7;9;61;43;Mönchengladbach;51.1965∘N;6.4385∘O;238;286;183;495;312;110;66;62;396;286
1971;1972;4;1. FC Köln;34;43;20;64;44;15;13;6;58;43;Köln;50.9333∘N;6.9500∘O;298;353;154;574;420;140;73;85;493;353
1971;1972;5;Eintracht Frankfurt;34;39;10;71;61;16;7;11;55;39;Frankfurt am Main;50.1109∘N;8.6821∘O;298;318;54;513;459;125;68;105;443;318
1971;1972;6;Hertha BSC Berlin;34;37;-9;46;55;14;9;11;51;37;Berlin;52.5200∘N;13.4050∘O;196;204;-15;290;305;78;48;70;282;204
1971;1972;7;1. FC Kaiserslautern;34;35;6;59;53;14;7;13;49;35;Kaiserslautern;49.4444∘N;7.7778∘O;298;274;-93;415;508;101;72;125;375;274
1971;1972;8;VfB Stuttgart;34;35;-4;52;56;13;9;12;48;35;Stuttgart;48.7833∘N;9.1833∘O;298;295;2;469;467;111;73;114;406;295
1971;1972;9;VfL Bochum;34;34;-10;59;69;14;6;14;48;34;Bochum;51.4818∘N;7.2163∘O;34;34;-10;59;69;14;6;14;48;34
1971;1972;10;Hamburger SV;34;33;0;52;52;13;7;14;46;33;Hamburg;53.5511∘N;9.9937∘O;298;297;-14;485;499;107;83;108;404;297
1971;1972;11;Werder Bremen;34;31;5;63;58;11;9;14;42;31;Bremen;53.0736∘N;8.8064∘O;298;316;59;501;442;120;76;102;436;316
1971;1972;12;Eintracht Braunschweig;34;31;-5;43;48;8;15;11;39;31;Braunschweig;52.2667∘N;10.5167∘O;298;303;3;394;391;110;83;105;413;303
1971;1972;13;Fortuna Düsseldorf;34;30;-13;40;53;10;10;14;40;30;Düsseldorf;51.2217∘N;6.7761∘O;68;55;-35;84;119;19;17;32;74;55
1971;1972;14;MSV Duisburg;34;27;-15;36;51;10;7;17;37;27;Duisburg;51.4333∘N;6.7667∘O;298;299;17;432;415;101;97;100;400;299
1971;1972;15;RW Oberhausen;34;25;-33;33;66;7;11;16;32;25;Oberhausen;51.4667∘N;6.8667∘O;102;81;-60;137;197;27;27;48;108;81
1971;1972;16;Hannover 96;34;23;-15;54;69;10;3;21;33;23;Hannover;52.3759∘N;9.7320∘O;268;249;-23;398;421;91;67;110;340;249
1971;1972;17;Borussia Dortmund;34;20;-49;34;83;6;8;20;26;20;Dortmund;51.5136∘N;7.4653∘O;298;301;32;537;505;116;69;113;417;301
1971;1972;18;Arminia Bielefeld;34;0;-34;41;75;0;0;21;0;0;Bielefeld;52.0211∘N;8.5342∘O;68;29;-53;75;128;12;5;38;41;29
1972;1973;1;Bayern München;34;54;64;93;29;25;4;5;79;54;München;48.1372∘N;11.5755∘O;272;372;304;618;314;159;54;59;531;372
1972;1973;2;1. FC Köln;34;43;15;66;51;16;11;7;59;43;Köln;50.9333∘N;6.9500∘O;332;396;169;640;471;156;84;92;552;396
1972;1973;3;Fortuna Düsseldorf;34;42;17;62;45;15;12;7;57;42;Düsseldorf;51.2217∘N;6.7761∘O;102;97;-18;146;164;34;29;39;131;97
1972;1973;4;Wuppertaler SV;34;40;13;62;49;15;10;9;55;40;Wuppertal;51.2583∘N;7.1500∘O;34;40;13;62;49;15;10;9;55;40
1972;1973;5;Bor. Mönchengladbach;34;39;21;82;61;17;5;12;56;39;Mönchengladbach;51.1965∘N;6.4385∘O;272;325;204;577;373;127;71;74;452;325
1972;1973;6;VfB Stuttgart;34;37;6;71;65;17;3;14;54;37;Stuttgart;48.7833∘N;9.1833∘O;332;332;8;540;532;128;76;128;460;332
1972;1973;7;Kickers Offenbach;34;35;1;61;60;14;7;13;49;35;Offenbach am Main;50.0898∘N;8.7618∘O;102;90;-32;152;184;33;24;45;123;90
1972;1973;8;Eintracht Frankfurt;34;34;4;58;54;15;4;15;49;34;Frankfurt am Main;50.1109∘N;8.6821∘O;332;352;58;571;513;140;72;120;492;352
1972;1973;9;1. FC Kaiserslautern;34;34;-10;58;68;12;10;12;46;34;Kaiserslautern;49.4444∘N;7.7778∘O;332;308;-103;473;576;113;82;137;421;308
1972;1973;10;MSV Duisburg;34;33;-1;53;54;12;9;13;45;33;Duisburg;51.4333∘N;6.7667∘O;332;332;16;485;469;113;106;113;445;332
1972;1973;11;Werder Bremen;34;31;-2;50;52;12;7;15;43;31;Bremen;53.0736∘N;8.8064∘O;332;347;57;551;494;132;83;117;479;347
1972;1973;12;VfL Bochum;34;31;-18;50;68;11;9;14;42;31;Bochum;51.4818∘N;7.2163∘O;68;65;-28;109;137;25;15;28;90;65
1972;1973;13;Hertha BSC Berlin;34;30;-11;53;64;11;8;15;41;30;Berlin;52.5200∘N;13.4050∘O;230;234;-26;343;369;89;56;85;323;234
1972;1973;14;Hamburger SV;34;28;-6;53;59;10;8;16;38;28;Hamburg;53.5511∘N;9.9937∘O;332;325;-20;538;558;117;91;124;442;325
1972;1973;15;Schalke 04;34;28;-15;46;61;10;8;16;38;28;Gelsenkirchen;51.5167∘N;7.0500∘O;332;323;-47;462;509;126;71;135;449;323
1972;1973;16;Hannover 96;34;26;-16;49;65;9;8;17;35;26;Hannover;52.3759∘N;9.7320∘O;302;275;-39;447;486;100;75;127;375;275
1972;1973;17;Eintracht Braunschweig;34;25;-23;33;56;9;7;18;34;25;Braunschweig;52.2667∘N;10.5167∘O;332;328;-20;427;447;119;90;123;447;328
1972;1973;18;RW Oberhausen;34;22;-39;45;84;9;4;21;31;22;Oberhausen;51.4667∘N;6.8667∘O;136;103;-99;182;281;36;31;69;139;103
1973;1974;1;Bayern München;34;49;42;95;53;20;9;5;69;49;München;48.1372∘N;11.5755∘O;306;421;346;713;367;179;63;64;600;421
1973;1974;2;Bor. Mönchengladbach;34;48;41;93;52;21;6;7;69;48;Mönchengladbach;51.1965∘N;6.4385∘O;306;373;245;670;425;148;77;81;521;373
1973;1974;3;Fortuna Düsseldorf;34;41;14;61;47;16;9;9;57;41;Düsseldorf;51.2217∘N;6.7761∘O;136;138;-4;207;211;50;38;48;188;138
1973;1974;4;Eintracht Frankfurt;34;41;13;63;50;15;11;8;56;41;Frankfurt am Main;50.1109∘N;8.6821∘O;366;393;71;634;563;155;83;128;548;393
1973;1974;5;1. FC Köln;34;39;13;69;56;16;7;11;55;39;Köln;50.9333∘N;6.9500∘O;366;435;182;709;527;172;91;103;607;435
1973;1974;6;1. FC Kaiserslautern;34;38;11;80;69;15;8;11;53;38;Kaiserslautern;49.4444∘N;7.7778∘O;366;346;-92;553;645;128;90;148;474;346
1973;1974;7;Schalke 04;34;37;4;72;68;16;5;13;53;37;Gelsenkirchen;51.5167∘N;7.0500∘O;366;360;-43;534;577;142;76;148;502;360
1973;1974;8;Hertha BSC Berlin;34;33;-4;56;60;11;11;12;44;33;Berlin;52.5200∘N;13.4050∘O;264;267;-30;399;429;100;67;97;367;267
1973;1974;9;VfB Stuttgart;34;31;1;58;57;12;7;15;43;31;Stuttgart;48.7833∘N;9.1833∘O;366;363;9;598;589;140;83;143;503;363
1973;1974;10;Kickers Offenbach;34;31;-6;56;62;11;9;14;42;31;Offenbach am Main;50.0898∘N;8.7618∘O;136;121;-38;208;246;44;33;59;165;121
1973;1974;11;Werder Bremen;34;31;-8;48;56;9;13;12;40;31;Bremen;53.0736∘N;8.8064∘O;366;378;49;599;550;141;96;129;519;378
1973;1974;12;Hamburger SV;34;31;-9;53;62;13;5;16;44;31;Hamburg;53.5511∘N;9.9937∘O;366;356;-29;591;620;130;96;140;486;356
1973;1974;13;RW Essen;34;31;-14;56;70;10;11;13;41;31;Essen;51.4556∘N;7.0125∘O;136;110;-65;180;245;31;48;57;141;110
1973;1974;14;VfL Bochum;34;30;-12;45;57;9;12;13;39;30;Bochum;51.4818∘N;7.2163∘O;102;95;-40;154;194;34;27;41;129;95
1973;1974;15;MSV Duisburg;34;29;-14;42;56;11;7;16;40;29;Duisburg;51.4333∘N;6.7667∘O;366;361;2;527;525;124;113;129;485;361
1973;1974;16;Wuppertaler SV;34;25;-23;42;65;8;9;17;33;25;Wuppertal;51.2583∘N;7.1500∘O;68;65;-10;104;114;23;19;26;88;65
1973;1974;17;Fortuna Köln;34;25;-33;46;79;8;9;17;33;25;Köln;50.9333∘N;6.9500∘O;34;25;-33;46;79;8;9;17;33;25
1973;1974;18;Hannover 96;34;22;-16;50;66;6;10;18;28;22;Hannover;52.3759∘N;9.7320∘O;336;297;-55;497;552;106;85;145;403;297
1974;1975;1;Bor. Mönchengladbach;34;50;46;86;40;21;8;5;71;50;Mönchengladbach;51.1965∘N;6.4385∘O;340;423;291;756;465;169;85;86;592;423
1974;1975;2;Hertha BSC Berlin;34;44;18;61;43;19;6;9;63;44;Berlin;52.5200∘N;13.4050∘O;298;311;-12;460;472;119;73;106;430;311
1974;1975;3;Eintracht Frankfurt;34;43;40;89;49;18;7;9;61;43;Frankfurt am Main;50.1109∘N;8.6821∘O;400;436;111;723;612;173;90;137;609;436
1974;1975;4;Hamburger SV;34;43;17;55;38;18;7;9;61;43;Hamburg;53.5511∘N;9.9937∘O;400;399;-12;646;658;148;103;149;547;399
1974;1975;5;1. FC Köln;34;41;26;77;51;17;7;10;58;41;Köln;50.9333∘N;6.9500∘O;400;476;208;786;578;189;98;113;665;476
1974;1975;6;Fortuna Düsseldorf;34;41;11;66;55;16;9;9;57;41;Düsseldorf;51.2217∘N;6.7761∘O;170;179;7;273;266;66;47;57;245;179
1974;1975;7;Schalke 04;34;39;15;52;37;16;7;11;55;39;Gelsenkirchen;51.5167∘N;7.0500∘O;400;399;-28;586;614;158;83;159;557;399
1974;1975;8;Kickers Offenbach;34;38;10;72;62;17;4;13;55;38;Offenbach am Main;50.0898∘N;8.7618∘O;170;159;-28;280;308;61;37;72;220;159
1974;1975;9;Eintracht Braunschweig;34;36;10;52;42;14;8;12;50;36;Braunschweig;52.2667∘N;10.5167∘O;366;364;-10;479;489;133;98;135;497;364
1974;1975;10;Bayern München;34;34;-6;57;63;14;6;14;48;34;München;48.1372∘N;11.5755∘O;340;455;340;770;430;193;69;78;648;455
1974;1975;11;VfL Bochum;34;33;0;53;53;14;5;15;47;33;Bochum;51.4818∘N;7.2163∘O;136;128;-40;207;247;48;32;56;176;128
1974;1975;12;RW Essen;34;32;-12;56;68;10;12;12;42;32;Essen;51.4556∘N;7.0125∘O;170;142;-77;236;313;41;60;69;183;142
1974;1975;13;1. FC Kaiserslautern;34;31;1;56;55;13;5;16;44;31;Kaiserslautern;49.4444∘N;7.7778∘O;400;377;-91;609;700;141;95;164;518;377
1974;1975;14;MSV Duisburg;34;30;-18;59;77;12;6;16;42;30;Duisburg;51.4333∘N;6.7667∘O;400;391;-16;586;602;136;119;145;527;391
1974;1975;15;Werder Bremen;34;25;-24;45;69;9;7;18;34;25;Bremen;53.0736∘N;8.8064∘O;400;403;25;644;619;150;103;147;553;403
1974;1975;16;VfB Stuttgart;34;24;-29;50;79;8;8;18;32;24;Stuttgart;48.7833∘N;9.1833∘O;400;387;-20;648;668;148;91;161;535;387
1974;1975;17;Tennis Borussia Berlin;34;16;-51;38;89;5;6;23;21;16;Berlin;52.5200∘N;13.4050∘O;34;16;-51;38;89;5;6;23;21;16
1974;1975;18;Wuppertaler SV;34;12;-54;32;86;2;8;24;14;12;Wuppertal;51.2583∘N;7.1500∘O;102;77;-64;136;200;25;27;50;102;77
1975;1976;1;Bor. Mönchengladbach;34;45;29;66;37;16;13;5;61;45;Mönchengladbach;51.1965∘N;6.4385∘O;374;468;320;822;502;185;98;91;653;468
1975;1976;2;Hamburger SV;34;41;27;59;32;17;7;10;58;41;Hamburg;53.5511∘N;9.9937∘O;434;440;15;705;690;165;110;159;605;440
1975;1976;3;Bayern München;34;40;22;72;50;15;10;9;55;40;München;48.1372∘N;11.5755∘O;374;495;362;842;480;208;79;87;703;495
1975;1976;4;1. FC Köln;34;39;17;62;45;14;11;9;53;39;Köln;50.9333∘N;6.9500∘O;434;515;225;848;623;203;109;122;718;515
1975;1976;5;Eintracht Braunschweig;34;39;4;52;48;14;11;9;53;39;Braunschweig;52.2667∘N;10.5167∘O;400;403;-6;531;537;147;109;144;550;403
1975;1976;6;Schalke 04;34;37;21;76;55;13;11;10;50;37;Gelsenkirchen;51.5167∘N;7.0500∘O;434;436;-7;662;669;171;94;169;607;436
1975;1976;7;1. FC Kaiserslautern;34;37;6;66;60;15;7;12;52;37;Kaiserslautern;49.4444∘N;7.7778∘O;434;414;-85;675;760;156;102;176;570;414
1975;1976;8;RW Essen;34;37;-6;61;67;13;11;10;50;37;Essen;51.4556∘N;7.0125∘O;204;179;-83;297;380;54;71;79;233;179
1975;1976;9;Eintracht Frankfurt;34;36;21;79;58;13;10;11;49;36;Frankfurt am Main;50.1109∘N;8.6821∘O;434;472;132;802;670;186;100;148;658;472
1975;1976;10;MSV Duisburg;34;33;-7;55;62;13;7;14;46;33;Duisburg;51.4333∘N;6.7667∘O;434;424;-23;641;664;149;126;159;573;424
1975;1976;11;Hertha BSC Berlin;34;32;-2;59;61;11;10;13;43;32;Berlin;52.5200∘N;13.4050∘O;332;343;-14;519;533;130;83;119;473;343
1975;1976;12;Fortuna Düsseldorf;34;30;-10;47;57;10;10;14;40;30;Düsseldorf;51.2217∘N;6.7761∘O;204;209;-3;320;323;76;57;71;285;209
1975;1976;13;Werder Bremen;34;30;-11;44;55;11;8;15;41;30;Bremen;53.0736∘N;8.8064∘O;434;433;14;688;674;161;111;162;594;433
1975;1976;14;VfL Bochum;34;30;-13;49;62;12;6;16;42;30;Bochum;51.4818∘N;7.2163∘O;170;158;-53;256;309;60;38;72;218;158
1975;1976;15;Karlsruher SC;34;30;-13;46;59;12;6;16;42;30;Karlsruhe;49.0069∘N;8.4037∘O;196;150;-123;256;379;55;40;101;205;150
1975;1976;16;Hannover 96;34;27;-12;48;60;9;9;16;36;27;Hannover;52.3759∘N;9.7320∘O;370;324;-67;545;612;115;94;161;439;324
1975;1976;17;Kickers Offenbach;34;27;-32;40;72;9;9;16;36;27;Offenbach am Main;50.0898∘N;8.7618∘O;204;186;-60;320;380;70;46;88;256;186
1975;1976;18;Bayer Uerdingen;34;22;-41;28;69;6;10;18;28;22;Krefeld;51.3340∘N;6.5684∘O;34;22;-41;28;69;6;10;18;28;22
1976;1977;1;Bor. Mönchengladbach;34;44;24;58;34;17;10;7;61;44;Mönchengladbach;51.1965∘N;6.4385∘O;408;512;344;880;536;202;108;98;714;512
1976;1977;2;Schalke 04;34;43;25;77;52;17;9;8;60;43;Gelsenkirchen;51.5167∘N;7.0500∘O;468;479;18;739;721;188;103;177;667;479
1976;1977;3;Eintracht Braunschweig;34;43;18;56;38;15;13;6;58;43;Braunschweig;52.2667∘N;10.5167∘O;434;446;12;587;575;162;122;150;608;446
1976;1977;4;Eintracht Frankfurt;34;42;29;86;57;17;8;9;59;42;Frankfurt am Main;50.1109∘N;8.6821∘O;468;514;161;888;727;203;108;157;717;514
1976;1977;5;1. FC Köln;34;40;22;83;61;17;6;11;57;40;Köln;50.9333∘N;6.9500∘O;468;555;247;931;684;220;115;133;775;555
1976;1977;6;Hamburger SV;34;38;11;67;56;14;10;10;52;38;Hamburg;53.5511∘N;9.9937∘O;468;478;26;772;746;179;120;169;657;478
1976;1977;7;Bayern München;34;37;9;74;65;14;9;11;51;37;München;48.1372∘N;11.5755∘O;408;532;371;916;545;222;88;98;754;532
1976;1977;8;Borussia Dortmund;34;34;9;73;64;12;10;12;46;34;Dortmund;51.5136∘N;7.4653∘O;332;335;41;610;569;128;79;125;463;335
1976;1977;9;MSV Duisburg;34;34;9;60;51;11;12;11;45;34;Duisburg;51.4333∘N;6.7667∘O;468;458;-14;701;715;160;138;170;618;458
1976;1977;10;Hertha BSC Berlin;34;34;1;55;54;13;8;13;47;34;Berlin;52.5200∘N;13.4050∘O;366;377;-13;574;587;143;91;132;520;377
1976;1977;11;Werder Bremen;34;33;-8;51;59;13;7;14;46;33;Bremen;53.0736∘N;8.8064∘O;468;466;6;739;733;174;118;176;640;466
1976;1977;12;Fortuna Düsseldorf;34;31;-2;52;54;11;9;14;42;31;Düsseldorf;51.2217∘N;6.7761∘O;238;240;-5;372;377;87;66;85;327;240
1976;1977;13;1. FC Kaiserslautern;34;29;-6;53;59;12;5;17;41;29;Kaiserslautern;49.4444∘N;7.7778∘O;468;443;-91;728;819;168;107;193;611;443
1976;1977;14;1. FC Saarbrücken;34;29;-12;43;55;9;11;14;38;29;Saarbrücken;49.2333∘N;7.0000∘O;64;46;-40;87;127;15;16;33;61;46
1976;1977;15;VfL Bochum;34;29;-15;47;62;11;7;16;40;29;Bochum;51.4818∘N;7.2163∘O;204;187;-68;303;371;71;45;88;258;187
1976;1977;16;Karlsruher SC;34;28;-22;53;75;9;10;15;37;28;Karlsruhe;49.0069∘N;8.4037∘O;230;178;-145;309;454;64;50;116;242;178
1976;1977;17;Tennis Borussia Berlin;34;22;-38;47;85;6;10;18;28;22;Berlin;52.5200∘N;13.4050∘O;68;38;-89;85;174;11;16;41;49;38
1976;1977;18;RW Essen;34;22;-54;49;103;7;8;19;29;22;Essen;51.4556∘N;7.0125∘O;238;201;-137;346;483;61;79;98;262;201
1977;1978;1;1. FC Köln;34;48;45;86;41;22;4;8;70;48;Köln;50.9333∘N;6.9500∘O;502;603;292;1017;725;242;119;141;845;603
1977;1978;2;Bor. Mönchengladbach;34;48;42;86;44;20;8;6;68;48;Mönchengladbach;51.1965∘N;6.4385∘O;442;560;386;966;580;222;116;104;782;560
1977;1978;3;Hertha BSC Berlin;34;40;11;59;48;15;10;9;55;40;Berlin;52.5200∘N;13.4050∘O;400;417;-2;633;635;158;101;141;575;417
1977;1978;4;VfB Stuttgart;34;39;18;58;40;17;5;12;56;39;Stuttgart;48.7833∘N;9.1833∘O;434;426;-2;706;708;165;96;173;591;426
1977;1978;5;Fortuna Düsseldorf;34;39;13;49;36;15;9;10;54;39;Düsseldorf;51.2217∘N;6.7761∘O;272;279;8;421;413;102;75;95;381;279
1977;1978;6;MSV Duisburg;34;37;3;62;59;15;7;12;52;37;Duisburg;51.4333∘N;6.7667∘O;502;495;-11;763;774;175;145;182;670;495
1977;1978;7;Eintracht Frankfurt;34;36;7;59;52;16;4;14;52;36;Frankfurt am Main;50.1109∘N;8.6821∘O;502;550;168;947;779;219;112;171;769;550
1977;1978;8;1. FC Kaiserslautern;34;36;1;64;63;16;4;14;52;36;Kaiserslautern;49.4444∘N;7.7778∘O;502;479;-90;792;882;184;111;207;663;479
1977;1978;9;Schalke 04;34;34;-5;47;52;14;6;14;48;34;Gelsenkirchen;51.5167∘N;7.0500∘O;502;513;13;786;773;202;109;191;715;513
1977;1978;10;Hamburger SV;34;34;-6;61;67;14;6;14;48;34;Hamburg;53.5511∘N;9.9937∘O;502;512;20;833;813;193;126;183;705;512
1977;1978;11;Borussia Dortmund;34;33;-14;57;71;14;5;15;47;33;Dortmund;51.5136∘N;7.4653∘O;366;368;27;667;640;142;84;140;510;368
1977;1978;12;Bayern München;34;32;-2;62;64;11;10;13;43;32;München;48.1372∘N;11.5755∘O;442;564;369;978;609;233;98;111;797;564
1977;1978;13;Eintracht Braunschweig;34;32;-10;43;53;14;4;16;46;32;Braunschweig;52.2667∘N;10.5167∘O;468;478;2;630;628;176;126;166;654;478
1977;1978;14;VfL Bochum;34;31;-2;49;51;11;9;14;42;31;Bochum;51.4818∘N;7.2163∘O;238;218;-70;352;422;82;54;102;300;218
1977;1978;15;Werder Bremen;34;31;-9;48;57;13;5;16;44;31;Bremen;53.0736∘N;8.8064∘O;502;497;-3;787;790;187;123;192;684;497
1977;1978;16;1860 München;34;22;-19;41;60;7;8;19;29;22;München;48.1372∘N;11.5755∘O;264;271;56;457;401;104;63;97;375;271
1977;1978;17;1. FC Saarbrücken;34;22;-31;39;70;6;10;18;28;22;Saarbrücken;49.2333∘N;7.0000∘O;98;68;-71;126;197;21;26;51;89;68
1977;1978;18;FC St. Pauli;34;18;-42;44;86;6;6;22;24;18;Hamburg;53.5511∘N;9.9937∘O;34;18;-42;44;86;6;6;22;24;18
1978;1979;1;Hamburger SV;34;49;46;78;32;21;7;6;70;49;Hamburg;53.5511∘N;9.9937∘O;536;561;66;911;845;214;133;189;775;561
1978;1979;2;VfB Stuttgart;34;48;39;73;34;20;8;6;68;48;Stuttgart;48.7833∘N;9.1833∘O;468;474;37;779;742;185;104;179;659;474
1978;1979;3;1. FC Kaiserslautern;34;43;15;62;47;16;11;7;59;43;Kaiserslautern;49.4444∘N;7.7778∘O;536;522;-75;854;929;200;122;214;722;522
1978;1979;4;Bayern München;34;40;23;69;46;16;8;10;56;40;München;48.1372∘N;11.5755∘O;476;604;392;1047;655;249;106;121;853;604
1978;1979;5;Eintracht Frankfurt;34;39;1;50;49;16;7;11;55;39;Frankfurt am Main;50.1109∘N;8.6821∘O;536;589;169;997;828;235;119;182;824;589
1978;1979;6;1. FC Köln;34;38;8;55;47;13;12;9;51;38;Köln;50.9333∘N;6.9500∘O;536;641;300;1072;772;255;131;150;896;641
1978;1979;7;Fortuna Düsseldorf;34;37;11;70;59;13;11;10;50;37;Düsseldorf;51.2217∘N;6.7761∘O;306;316;19;491;472;115;86;105;431;316
1978;1979;8;VfL Bochum;34;33;1;47;46;10;13;11;43;33;Bochum;51.4818∘N;7.2163∘O;272;251;-69;399;468;92;67;113;343;251
1978;1979;9;Eintracht Braunschweig;34;33;-5;50;55;10;13;11;43;33;Braunschweig;52.2667∘N;10.5167∘O;502;511;-3;680;683;186;139;177;697;511
1978;1979;10;Bor. Mönchengladbach;34;32;-3;50;53;12;8;14;44;32;Mönchengladbach;51.1965∘N;6.4385∘O;476;592;383;1016;633;234;124;118;826;592
1978;1979;11;Werder Bremen;34;31;-12;48;60;10;11;13;41;31;Bremen;53.0736∘N;8.8064∘O;536;528;-15;835;850;197;134;205;725;528
1978;1979;12;Borussia Dortmund;34;31;-16;54;70;10;11;13;41;31;Dortmund;51.5136∘N;7.4653∘O;400;399;11;721;710;152;95;153;551;399
1978;1979;13;MSV Duisburg;34;30;-13;43;56;12;6;16;42;30;Duisburg;51.4333∘N;6.7667∘O;536;525;-24;806;830;187;151;198;712;525
1978;1979;14;Hertha BSC Berlin;34;29;-10;40;50;9;11;14;38;29;Berlin;52.5200∘N;13.4050∘O;434;446;-12;673;685;167;112;155;613;446
1978;1979;15;Schalke 04;34;28;-6;55;61;9;10;15;37;28;Gelsenkirchen;51.5167∘N;7.0500∘O;536;541;7;841;834;211;119;206;752;541
1978;1979;16;Arminia Bielefeld;34;26;-13;43;56;9;8;17;35;26;Bielefeld;52.0211∘N;8.5342∘O;102;55;-66;118;184;21;13;55;76;55
1978;1979;17;1. FC Nürnberg;34;24;-31;36;67;8;8;18;32;24;Nürnberg;49.4521∘N;11.0767∘O;230;234;-8;338;346;84;66;80;318;234
1978;1979;18;Darmstadt 98;34;21;-35;40;75;7;7;20;28;21;Darmstadt;49.8728∘N;8.6517∘O;34;21;-35;40;75;7;7;20;28;21
1979;1980;1;Bayern München;34;50;51;84;33;22;6;6;72;50;München;48.1372∘N;11.5755∘O;510;654;443;1131;688;271;112;127;925;654
1979;1980;2;Hamburger SV;34;48;51;86;35;20;8;6;68;48;Hamburg;53.5511∘N;9.9937∘O;570;609;117;997;880;234;141;195;843;609
1979;1980;3;VfB Stuttgart;34;41;22;75;53;17;7;10;58;41;Stuttgart;48.7833∘N;9.1833∘O;502;515;59;854;795;202;111;189;717;515
1979;1980;4;1. FC Kaiserslautern;34;41;22;75;53;18;5;11;59;41;Kaiserslautern;49.4444∘N;7.7778∘O;570;563;-53;929;982;218;127;225;781;563
1979;1980;5;1. FC Köln;34;37;17;72;55;14;9;11;51;37;Köln;50.9333∘N;6.9500∘O;570;678;317;1144;827;269;140;161;947;678
1979;1980;6;Borussia Dortmund;34;36;8;64;56;14;8;12;50;36;Dortmund;51.5136∘N;7.4653∘O;434;435;19;785;766;166;103;165;601;435
1979;1980;7;Bor. Mönchengladbach;34;36;1;61;60;12;12;10;48;36;Mönchengladbach;51.1965∘N;6.4385∘O;510;628;384;1077;693;246;136;128;874;628
1979;1980;8;Schalke 04;34;33;-11;40;51;12;9;13;45;33;Gelsenkirchen;51.5167∘N;7.0500∘O;570;574;-4;881;885;223;128;219;797;574
1979;1980;9;Eintracht Frankfurt;34;32;4;65;61;15;2;17;47;32;Frankfurt am Main;50.1109∘N;8.6821∘O;570;621;173;1062;889;250;121;199;871;621
1979;1980;10;VfL Bochum;34;32;-3;41;44;13;6;15;45;32;Bochum;51.4818∘N;7.2163∘O;306;283;-72;440;512;105;73;128;388;283
1979;1980;11;Fortuna Düsseldorf;34;32;-10;62;72;13;6;15;45;32;Düsseldorf;51.2217∘N;6.7761∘O;340;348;9;553;544;128;92;120;476;348
1979;1980;12;Bayer Leverkusen;34;32;-16;45;61;12;8;14;44;32;Leverkusen;51.0416∘N;7.0004∘O;34;32;-16;45;61;12;8;14;44;32
1979;1980;13;1860 München;34;30;-11;42;53;10;10;14;40;30;München;48.1372∘N;11.5755∘O;298;301;45;499;454;114;73;111;415;301
1979;1980;14;MSV Duisburg;34;29;-14;43;57;11;7;16;40;29;Duisburg;51.4333∘N;6.7667∘O;570;554;-38;849;887;198;158;214;752;554
1979;1980;15;Bayer Uerdingen;34;29;-18;43;61;12;5;17;41;29;Krefeld;51.3340∘N;6.5684∘O;68;51;-59;71;130;18;15;35;69;51
1979;1980;16;Hertha BSC Berlin;34;29;-20;41;61;11;7;16;40;29;Berlin;52.5200∘N;13.4050∘O;468;475;-32;714;746;178;119;171;653;475
1979;1980;17;Werder Bremen;34;25;-41;52;93;11;3;20;36;25;Bremen;53.0736∘N;8.8064∘O;570;553;-56;887;943;208;137;225;761;553
1979;1980;18;Eintracht Braunschweig;34;20;-32;32;64;6;8;20;26;20;Braunschweig;52.2667∘N;10.5167∘O;536;531;-35;712;747;192;147;197;723;531
1980;1981;1;Bayern München;34;53;48;89;41;22;9;3;75;53;München;48.1372∘N;11.5755∘O;544;707;491;1220;729;293;121;130;1000;707
1980;1981;2;Hamburger SV;34;49;30;73;43;21;7;6;70;49;Hamburg;53.5511∘N;9.9937∘O;604;658;147;1070;923;255;148;201;913;658
1980;1981;3;VfB Stuttgart;34;46;26;70;44;19;8;7;65;46;Stuttgart;48.7833∘N;9.1833∘O;536;561;85;924;839;221;119;196;782;561
1980;1981;4;1. FC Kaiserslautern;34;44;23;60;37;17;10;7;61;44;Kaiserslautern;49.4444∘N;7.7778∘O;604;607;-30;989;1019;235;137;232;842;607
1980;1981;5;Eintracht Frankfurt;34;38;4;61;57;13;12;9;51;38;Frankfurt am Main;50.1109∘N;8.6821∘O;604;659;177;1123;946;263;133;208;922;659
1980;1981;6;Bor. Mönchengladbach;34;37;4;68;64;15;7;12;52;37;Mönchengladbach;51.1965∘N;6.4385∘O;544;665;388;1145;757;261;143;140;926;665
1980;1981;7;Borussia Dortmund;34;35;10;69;59;13;9;12;48;35;Dortmund;51.5136∘N;7.4653∘O;468;470;29;854;825;179;112;177;649;470
1980;1981;8;1. FC Köln;34;34;-1;54;55;12;10;12;46;34;Köln;50.9333∘N;6.9500∘O;604;712;316;1198;882;281;150;173;993;712
1980;1981;9;VfL Bochum;34;33;8;53;45;9;15;10;42;33;Bochum;51.4818∘N;7.2163∘O;340;316;-64;493;557;114;88;138;430;316
1980;1981;10;Karlsruher SC;34;32;-7;56;63;9;14;11;41;32;Karlsruhe;49.0069∘N;8.4037∘O;264;210;-152;365;517;73;64;127;283;210
1980;1981;11;Bayer Leverkusen;34;30;-1;52;53;10;10;14;40;30;Leverkusen;51.0416∘N;7.0004∘O;68;62;-17;97;114;22;18;28;84;62
1980;1981;12;MSV Duisburg;34;29;-13;45;58;10;9;15;39;29;Duisburg;51.4333∘N;6.7667∘O;604;583;-51;894;945;208;167;229;791;583
1980;1981;13;Fortuna Düsseldorf;34;28;-7;57;64;10;8;16;38;28;Düsseldorf;51.2217∘N;6.7761∘O;374;376;2;610;608;138;100;136;514;376
1980;1981;14;1. FC Nürnberg;34;28;-10;47;57;11;6;17;39;28;Nürnberg;49.4521∘N;11.0767∘O;264;262;-18;385;403;95;72;97;357;262
1980;1981;15;Arminia Bielefeld;34;26;-19;46;65;10;6;18;36;26;Bielefeld;52.0211∘N;8.5342∘O;136;81;-85;164;249;31;19;73;112;81
1980;1981;16;1860 München;34;25;-18;49;67;9;7;18;34;25;München;48.1372∘N;11.5755∘O;332;326;27;548;521;123;80;129;449;326
1980;1981;17;Schalke 04;34;23;-45;43;88;8;7;19;31;23;Gelsenkirchen;51.5167∘N;7.0500∘O;604;597;-49;924;973;231;135;238;828;597
1980;1981;18;Bayer Uerdingen;34;22;-32;47;79;8;6;20;30;22;Krefeld;51.3340∘N;6.5684∘O;102;73;-91;118;209;26;21;55;99;73
1981;1982;1;Hamburger SV;34;48;50;95;45;18;12;4;66;48;Hamburg;53.5511∘N;9.9937∘O;638;706;197;1165;968;273;160;205;979;706
1981;1982;2;1. FC Köln;34;45;34;72;38;18;9;7;63;45;Köln;50.9333∘N;6.9500∘O;638;757;350;1270;920;299;159;180;1056;757
1981;1982;3;Bayern München;34;43;21;77;56;20;3;11;63;43;München;48.1372∘N;11.5755∘O;578;750;512;1297;785;313;124;141;1063;750
1981;1982;4;1. FC Kaiserslautern;34;42;9;70;61;16;10;8;58;42;Kaiserslautern;49.4444∘N;7.7778∘O;638;649;-21;1059;1080;251;147;240;900;649
1981;1982;5;Werder Bremen;34;42;9;61;52;17;8;9;59;42;Bremen;53.0736∘N;8.8064∘O;604;595;-47;948;995;225;145;234;820;595
1981;1982;6;Borussia Dortmund;34;41;19;59;40;18;5;11;59;41;Dortmund;51.5136∘N;7.4653∘O;502;511;48;913;865;197;117;188;708;511
1981;1982;7;Bor. Mönchengladbach;34;40;10;61;51;15;10;9;55;40;Mönchengladbach;51.1965∘N;6.4385∘O;578;705;398;1206;808;276;153;149;981;705
1981;1982;8;Eintracht Frankfurt;34;37;11;83;72;17;3;14;54;37;Frankfurt am Main;50.1109∘N;8.6821∘O;638;696;188;1206;1018;280;136;222;976;696
1981;1982;9;VfB Stuttgart;34;35;7;62;55;13;9;12;48;35;Stuttgart;48.7833∘N;9.1833∘O;570;596;92;986;894;234;128;208;830;596
1981;1982;10;VfL Bochum;34;32;1;52;51;12;8;14;44;32;Bochum;51.4818∘N;7.2163∘O;374;348;-63;545;608;126;96;152;474;348
1981;1982;11;Eintracht Braunschweig;34;32;-5;61;66;14;4;16;46;32;Braunschweig;52.2667∘N;10.5167∘O;570;563;-40;773;813;206;151;213;769;563
1981;1982;12;Arminia Bielefeld;34;30;-4;46;50;12;6;16;42;30;Bielefeld;52.0211∘N;8.5342∘O;170;111;-89;210;299;43;25;89;154;111
1981;1982;13;1. FC Nürnberg;34;28;-19;53;72;11;6;17;39;28;Nürnberg;49.4521∘N;11.0767∘O;298;290;-37;438;475;106;78;114;396;290
1981;1982;14;Karlsruher SC;34;27;-18;50;68;9;9;16;36;27;Karlsruhe;49.0069∘N;8.4037∘O;298;237;-170;415;585;82;73;143;319;237
1981;1982;15;Fortuna Düsseldorf;34;25;-25;48;73;6;13;15;31;25;Düsseldorf;51.2217∘N;6.7761∘O;408;401;-23;658;681;144;113;151;545;401
1981;1982;16;Bayer Leverkusen;34;25;-27;45;72;9;7;18;34;25;Leverkusen;51.0416∘N;7.0004∘O;102;87;-44;142;186;31;25;46;118;87
1981;1982;17;Darmstadt 98;34;21;-36;46;82;5;11;18;26;21;Darmstadt;49.8728∘N;8.6517∘O;68;42;-71;86;157;12;18;38;54;42
1981;1982;18;MSV Duisburg;34;19;-37;40;77;8;3;23;27;19;Duisburg;51.4333∘N;6.7667∘O;638;602;-88;934;1022;216;170;252;818;602
1982;1983;1;Hamburger SV;34;52;46;79;33;20;12;2;72;52;Hamburg;53.5511∘N;9.9937∘O;672;758;243;1244;1001;293;172;207;1051;758
1982;1983;2;Werder Bremen;34;52;38;76;38;23;6;5;75;52;Bremen;53.0736∘N;8.8064∘O;638;647;-9;1024;1033;248;151;239;895;647
1982;1983;3;VfB Stuttgart;34;48;33;80;47;20;8;6;68;48;Stuttgart;48.7833∘N;9.1833∘O;604;644;125;1066;941;254;136;214;898;644
1982;1983;4;Bayern München;34;44;41;74;33;17;10;7;61;44;München;48.1372∘N;11.5755∘O;612;794;553;1371;818;330;134;148;1124;794
1982;1983;5;1. FC Köln;34;43;27;69;42;17;9;8;60;43;Köln;50.9333∘N;6.9500∘O;672;800;377;1339;962;316;168;188;1116;800
1982;1983;6;1. FC Kaiserslautern;34;41;13;57;44;14;13;7;55;41;Kaiserslautern;49.4444∘N;7.7778∘O;672;690;-8;1116;1124;265;160;247;955;690
1982;1983;7;Borussia Dortmund;34;39;16;78;62;16;7;11;55;39;Dortmund;51.5136∘N;7.4653∘O;536;550;64;991;927;213;124;199;763;550
1982;1983;8;Arminia Bielefeld;34;31;-25;46;71;12;7;15;43;31;Bielefeld;52.0211∘N;8.5342∘O;204;142;-114;256;370;55;32;104;197;142
1982;1983;9;Fortuna Düsseldorf;34;30;-12;63;75;11;8;15;41;30;Düsseldorf;51.2217∘N;6.7761∘O;442;431;-35;721;756;155;121;166;586;431
1982;1983;10;Eintracht Frankfurt;34;29;-9;48;57;12;5;17;41;29;Frankfurt am Main;50.1109∘N;8.6821∘O;672;725;179;1254;1075;292;141;239;1017;725
1982;1983;11;Bayer Leverkusen;34;29;-23;43;66;10;9;15;39;29;Leverkusen;51.0416∘N;7.0004∘O;136;116;-67;185;252;41;34;61;157;116
1982;1983;12;Bor. Mönchengladbach;34;28;1;64;63;12;4;18;40;28;Mönchengladbach;51.1965∘N;6.4385∘O;612;733;399;1270;871;288;157;167;1021;733
1982;1983;13;VfL Bochum;34;28;-6;43;49;8;12;14;36;28;Bochum;51.4818∘N;7.2163∘O;408;376;-69;588;657;134;108;166;510;376
1982;1983;14;1. FC Nürnberg;34;28;-26;44;70;11;6;17;39;28;Nürnberg;49.4521∘N;11.0767∘O;332;318;-63;482;545;117;84;131;435;318
1982;1983;15;Eintracht Braunschweig;34;27;-23;42;65;8;11;15;35;27;Braunschweig;52.2667∘N;10.5167∘O;604;590;-63;815;878;214;162;228;804;590
1982;1983;16;Schalke 04;34;22;-20;48;68;8;6;20;30;22;Gelsenkirchen;51.5167∘N;7.0500∘O;638;619;-69;972;1041;239;141;258;858;619
1982;1983;17;Karlsruher SC;34;21;-47;39;86;7;7;20;28;21;Karlsruhe;49.0069∘N;8.4037∘O;332;258;-217;454;671;89;80;163;347;258
1982;1983;18;Hertha BSC Berlin;34;20;-24;43;67;5;10;19;25;20;Berlin;52.5200∘N;13.4050∘O;502;495;-56;757;813;183;129;190;678;495
1983;1984;1;VfB Stuttgart;34;48;46;79;33;19;10;5;67;48;Stuttgart;48.7833∘N;9.1833∘O;638;692;171;1145;974;273;146;219;965;692
1983;1984;2;Hamburger SV;34;48;39;75;36;21;6;7;69;48;Hamburg;53.5511∘N;9.9937∘O;706;806;282;1319;1037;314;178;214;1120;806
1983;1984;3;Bor. Mönchengladbach;34;48;33;81;48;21;6;7;69;48;Mönchengladbach;51.1965∘N;6.4385∘O;646;781;432;1351;919;309;163;174;1090;781
1983;1984;4;Bayern München;34;47;43;84;41;20;7;7;67;47;München;48.1372∘N;11.5755∘O;646;841;596;1455;859;350;141;155;1191;841
1983;1984;5;Werder Bremen;34;45;33;79;46;19;7;8;64;45;Bremen;53.0736∘N;8.8064∘O;672;692;24;1103;1079;267;158;247;959;692
1983;1984;6;1. FC Köln;34;38;13;70;57;16;6;12;54;38;Köln;50.9333∘N;6.9500∘O;706;838;390;1409;1019;332;174;200;1170;838
1983;1984;7;Bayer Leverkusen;34;34;0;50;50;13;8;13;47;34;Leverkusen;51.0416∘N;7.0004∘O;170;150;-67;235;302;54;42;74;204;150
1983;1984;8;Arminia Bielefeld;34;33;-9;40;49;12;9;13;45;33;Bielefeld;52.0211∘N;8.5342∘O;238;175;-123;296;419;67;41;117;242;175
1983;1984;9;Eintracht Braunschweig;34;32;-15;54;69;13;6;15;45;32;Braunschweig;52.2667∘N;10.5167∘O;638;622;-78;869;947;227;168;243;849;622
1983;1984;10;Bayer Uerdingen;34;31;-13;66;79;12;7;15;43;31;Krefeld;51.3340∘N;6.5684∘O;136;104;-104;184;288;38;28;70;142;104
1983;1984;11;Waldhof Mannheim;34;31;-13;45;58;10;11;13;41;31;Mannheim;49.4891∘N;8.4669∘O;34;31;-13;45;58;10;11;13;41;31
1983;1984;12;1. FC Kaiserslautern;34;30;-1;68;69;12;6;16;42;30;Kaiserslautern;49.4444∘N;7.7778∘O;706;720;-9;1184;1193;277;166;263;997;720
1983;1984;13;Borussia Dortmund;34;30;-11;54;65;11;8;15;41;30;Dortmund;51.5136∘N;7.4653∘O;570;580;53;1045;992;224;132;214;804;580
1983;1984;14;Fortuna Düsseldorf;34;29;-12;63;75;11;7;16;40;29;Düsseldorf;51.2217∘N;6.7761∘O;476;460;-47;784;831;166;128;182;626;460
1983;1984;15;VfL Bochum;34;28;-12;58;70;10;8;16;38;28;Bochum;51.4818∘N;7.2163∘O;442;404;-81;646;727;144;116;182;548;404
1983;1984;16;Eintracht Frankfurt;34;27;-16;45;61;7;13;14;34;27;Frankfurt am Main;50.1109∘N;8.6821∘O;706;752;163;1299;1136;299;154;253;1051;752
1983;1984;17;Kickers Offenbach;34;19;-58;48;106;7;5;22;26;19;Offenbach am Main;50.0898∘N;8.7618∘O;238;205;-118;368;486;77;51;110;282;205
1983;1984;18;1. FC Nürnberg;34;14;-47;38;85;6;2;26;20;14;Nürnberg;49.4521∘N;11.0767∘O;366;332;-110;520;630;123;86;157;455;332
1984;1985;1;Bayern München;34;50;41;79;38;21;8;5;71;50;München;48.1372∘N;11.5755∘O;680;891;637;1534;897;371;149;160;1262;891
1984;1985;2;Werder Bremen;34;46;36;87;51;18;10;6;64;46;Bremen;53.0736∘N;8.8064∘O;706;738;60;1190;1130;285;168;253;1023;738
1984;1985;3;1. FC Köln;34;40;3;69;66;18;4;12;58;40;Köln;50.9333∘N;6.9500∘O;740;878;393;1478;1085;350;178;212;1228;878
1984;1985;4;Bor. Mönchengladbach;34;39;24;77;53;15;9;10;54;39;Mönchengladbach;51.1965∘N;6.4385∘O;680;820;456;1428;972;324;172;184;1144;820
1984;1985;5;Hamburger SV;34;37;9;58;49;14;9;11;51;37;Hamburg;53.5511∘N;9.9937∘O;740;843;291;1377;1086;328;187;225;1171;843
1984;1985;6;Waldhof Mannheim;34;37;-3;47;50;13;11;10;50;37;Mannheim;49.4891∘N;8.4669∘O;68;68;-16;92;108;23;22;23;91;68
1984;1985;7;Bayer Uerdingen;34;36;5;57;52;14;8;12;50;36;Krefeld;51.3340∘N;6.5684∘O;170;140;-99;241;340;52;36;82;192;140
1984;1985;8;Schalke 04;34;34;1;63;62;13;8;13;47;34;Gelsenkirchen;51.5167∘N;7.0500∘O;672;653;-68;1035;1103;252;149;271;905;653
1984;1985;9;VfL Bochum;34;34;-2;52;54;12;10;12;46;34;Bochum;51.4818∘N;7.2163∘O;476;438;-83;698;781;156;126;194;594;438
1984;1985;10;VfB Stuttgart;34;33;20;79;59;14;5;15;47;33;Stuttgart;48.7833∘N;9.1833∘O;672;725;191;1224;1033;287;151;234;1012;725
1984;1985;11;1. FC Kaiserslautern;34;33;-4;56;60;11;11;12;44;33;Kaiserslautern;49.4444∘N;7.7778∘O;740;753;-13;1240;1253;288;177;275;1041;753
1984;1985;12;Eintracht Frankfurt;34;32;-5;62;67;10;12;12;42;32;Frankfurt am Main;50.1109∘N;8.6821∘O;740;784;158;1361;1203;309;166;265;1093;784
1984;1985;13;Bayer Leverkusen;34;31;-2;52;54;9;13;12;40;31;Leverkusen;51.0416∘N;7.0004∘O;204;181;-69;287;356;63;55;86;244;181
1984;1985;14;Borussia Dortmund;34;30;-14;51;65;13;4;17;43;30;Dortmund;51.5136∘N;7.4653∘O;604;610;39;1096;1057;237;136;231;847;610
1984;1985;15;Fortuna Düsseldorf;34;29;-13;53;66;10;9;15;39;29;Düsseldorf;51.2217∘N;6.7761∘O;510;489;-60;837;897;176;137;197;665;489
1984;1985;16;Arminia Bielefeld;34;29;-15;46;61;8;13;13;37;29;Bielefeld;52.0211∘N;8.5342∘O;272;204;-138;342;480;75;54;130;279;204
1984;1985;17;Karlsruher SC;34;22;-41;47;88;5;12;17;27;22;Karlsruhe;49.0069∘N;8.4037∘O;366;280;-258;501;759;94;92;180;374;280
1984;1985;18;Eintracht Braunschweig;34;20;-40;39;79;9;2;23;29;20;Braunschweig;52.2667∘N;10.5167∘O;672;642;-118;908;1026;236;170;266;878;642
1985;1986;1;Bayern München;34;49;51;82;31;21;7;6;70;49;München;48.1372∘N;11.5755∘O;714;940;688;1616;928;392;156;166;1332;940
1985;1986;2;Werder Bremen;34;49;42;83;41;20;9;5;69;49;Bremen;53.0736∘N;8.8064∘O;740;787;102;1273;1171;305;177;258;1092;787
1985;1986;3;Bayer Uerdingen;34;45;3;63;60;19;7;8;64;45;Krefeld;51.3340∘N;6.5684∘O;204;185;-96;304;400;71;43;90;256;185
1985;1986;4;Bor. Mönchengladbach;34;42;14;65;51;15;12;7;57;42;Mönchengladbach;51.1965∘N;6.4385∘O;714;862;470;1493;1023;339;184;191;1201;862
1985;1986;5;VfB Stuttgart;34;41;24;69;45;17;7;10;58;41;Stuttgart;48.7833∘N;9.1833∘O;706;766;215;1293;1078;304;158;244;1070;766
1985;1986;6;Bayer Leverkusen;34;40;12;63;51;15;10;9;55;40;Leverkusen;51.0416∘N;7.0004∘O;238;221;-57;350;407;78;65;95;299;221
1985;1986;7;Hamburger SV;34;39;17;52;35;17;5;12;56;39;Hamburg;53.5511∘N;9.9937∘O;774;882;308;1429;1121;345;192;237;1227;882
1985;1986;8;Waldhof Mannheim;34;33;-3;41;44;11;11;12;44;33;Mannheim;49.4891∘N;8.4669∘O;102;101;-19;133;152;34;33;35;135;101
1985;1986;9;VfL Bochum;34;32;-2;55;57;14;4;16;46;32;Bochum;51.4818∘N;7.2163∘O;510;470;-85;753;838;170;130;210;640;470
1985;1986;10;Schalke 04;34;30;-5;53;58;11;8;15;41;30;Gelsenkirchen;51.5167∘N;7.0500∘O;706;683;-73;1088;1161;263;157;286;946;683
1985;1986;11;1. FC Kaiserslautern;34;30;-5;49;54;10;10;14;40;30;Kaiserslautern;49.4444∘N;7.7778∘O;774;783;-18;1289;1307;298;187;289;1081;783
1985;1986;12;1. FC Nürnberg;34;29;-3;51;54;12;5;17;41;29;Nürnberg;49.4521∘N;11.0767∘O;400;361;-113;571;684;135;91;174;496;361
1985;1986;13;1. FC Köln;34;29;-13;46;59;9;11;14;38;29;Köln;50.9333∘N;6.9500∘O;774;907;380;1524;1144;359;189;226;1266;907
1985;1986;14;Fortuna Düsseldorf;34;29;-24;54;78;11;7;16;40;29;Düsseldorf;51.2217∘N;6.7761∘O;544;518;-84;891;975;187;144;213;705;518
1985;1986;15;Eintracht Frankfurt;34;28;-14;35;49;7;14;13;35;28;Frankfurt am Main;50.1109∘N;8.6821∘O;774;812;144;1396;1252;316;180;278;1128;812
1985;1986;16;Borussia Dortmund;34;28;-16;49;65;10;8;16;38;28;Dortmund;51.5136∘N;7.4653∘O;638;638;23;1145;1122;247;144;247;885;638
1985;1986;17;1. FC Saarbrücken;34;21;-29;39;68;6;9;19;27;21;Saarbrücken;49.2333∘N;7.0000∘O;132;89;-100;165;265;27;35;70;116;89
1985;1986;18;Hannover 96;34;18;-49;43;92;5;8;21;23;18;Hannover;52.3759∘N;9.7320∘O;404;342;-116;588;704;120;102;182;462;342
1986;1987;1;Bayern München;34;53;36;67;31;20;13;1;73;53;München;48.1372∘N;11.5755∘O;748;993;724;1683;959;412;169;167;1405;993
1986;1987;2;Hamburger SV;34;47;32;69;37;19;9;6;66;47;Hamburg;53.5511∘N;9.9937∘O;808;929;340;1498;1158;364;201;243;1293;929
1986;1987;3;Bor. Mönchengladbach;34;43;30;74;44;18;7;9;61;43;Mönchengladbach;51.1965∘N;6.4385∘O;748;905;500;1567;1067;357;191;200;1262;905
1986;1987;4;Borussia Dortmund;34;40;20;70;50;15;10;9;55;40;Dortmund;51.5136∘N;7.4653∘O;672;678;43;1215;1172;262;154;256;940;678
1986;1987;5;Werder Bremen;34;40;11;65;54;17;6;11;57;40;Bremen;53.0736∘N;8.8064∘O;774;827;113;1338;1225;322;183;269;1149;827
1986;1987;6;Bayer Leverkusen;34;39;18;56;38;16;7;11;55;39;Leverkusen;51.0416∘N;7.0004∘O;272;260;-39;406;445;94;72;106;354;260
1986;1987;7;1. FC Kaiserslautern;34;37;13;64;51;15;7;12;52;37;Kaiserslautern;49.4444∘N;7.7778∘O;808;820;-5;1353;1358;313;194;301;1133;820
1986;1987;8;Bayer Uerdingen;34;35;2;51;49;12;11;11;47;35;Krefeld;51.3340∘N;6.5684∘O;238;220;-94;355;449;83;54;101;303;220
1986;1987;9;1. FC Nürnberg;34;35;0;62;62;12;11;11;47;35;Nürnberg;49.4521∘N;11.0767∘O;434;396;-113;633;746;147;102;185;543;396
1986;1987;10;1. FC Köln;34;35;-3;50;53;13;9;12;48;35;Köln;50.9333∘N;6.9500∘O;808;942;377;1574;1197;372;198;238;1314;942
1986;1987;11;VfL Bochum;34;32;8;52;44;9;14;11;41;32;Bochum;51.4818∘N;7.2163∘O;544;502;-77;805;882;179;144;221;681;502
1986;1987;12;VfB Stuttgart;34;32;6;55;49;13;6;15;45;32;Stuttgart;48.7833∘N;9.1833∘O;740;798;221;1348;1127;317;164;259;1115;798
1986;1987;13;Schalke 04;34;32;-8;50;58;12;8;14;44;32;Gelsenkirchen;51.5167∘N;7.0500∘O;740;715;-81;1138;1219;275;165;300;990;715
1986;1987;14;Waldhof Mannheim;34;28;-19;52;71;10;8;16;38;28;Mannheim;49.4891∘N;8.4669∘O;136;129;-38;185;223;44;41;51;173;129
1986;1987;15;Eintracht Frankfurt;34;25;-11;42;53;8;9;17;33;25;Frankfurt am Main;50.1109∘N;8.6821∘O;808;837;133;1438;1305;324;189;295;1161;837
1986;1987;16;FC Homburg;34;21;-46;33;79;6;9;19;27;21;Homburg;49.3283∘N;7.3400∘O;34;21;-46;33;79;6;9;19;27;21
1986;1987;17;Fortuna Düsseldorf;34;20;-49;42;91;7;6;21;27;20;Düsseldorf;51.2217∘N;6.7761∘O;578;538;-133;933;1066;194;150;234;732;538
1986;1987;18;BW 90 Berlin;34;18;-40;36;76;3;12;19;21;18;Berlin;52.5200∘N;13.4050∘O;34;18;-40;36;76;3;12;19;21;18
1987;1988;1;Werder Bremen;34;52;39;61;22;22;8;4;74;52;Bremen;53.0736∘N;8.8064∘O;808;879;152;1399;1247;344;191;273;1223;879
1987;1988;2;Bayern München;34;48;38;83;45;22;4;8;70;48;München;48.1372∘N;11.5755∘O;782;1041;762;1766;1004;434;173;175;1475;1041
1987;1988;3;1. FC Köln;34;48;29;57;28;18;12;4;66;48;Köln;50.9333∘N;6.9500∘O;842;990;406;1631;1225;390;210;242;1380;990
1987;1988;4;VfB Stuttgart;34;40;20;69;49;16;8;10;56;40;Stuttgart;48.7833∘N;9.1833∘O;774;838;241;1417;1176;333;172;269;1171;838
1987;1988;5;1. FC Nürnberg;34;37;4;44;40;13;11;10;50;37;Nürnberg;49.4521∘N;11.0767∘O;468;433;-109;677;786;160;113;195;593;433
1987;1988;6;Hamburger SV;34;37;-5;63;68;13;11;10;50;37;Hamburg;53.5511∘N;9.9937∘O;842;966;335;1561;1226;377;212;253;1343;966
1987;1988;7;Bor. Mönchengladbach;34;33;2;55;53;14;5;15;47;33;Mönchengladbach;51.1965∘N;6.4385∘O;782;938;502;1622;1120;371;196;215;1309;938
1987;1988;8;Bayer Leverkusen;34;32;-7;53;60;10;12;12;42;32;Leverkusen;51.0416∘N;7.0004∘O;306;292;-46;459;505;104;84;118;396;292
1987;1988;9;Eintracht Frankfurt;34;31;1;51;50;10;11;13;41;31;Frankfurt am Main;50.1109∘N;8.6821∘O;842;868;134;1489;1355;334;200;308;1202;868
1987;1988;10;Hannover 96;34;31;-1;59;60;12;7;15;43;31;Hannover;52.3759∘N;9.7320∘O;438;373;-117;647;764;132;109;197;505;373
1987;1988;11;Bayer Uerdingen;34;31;-2;59;61;11;9;14;42;31;Krefeld;51.3340∘N;6.5684∘O;272;251;-96;414;510;94;63;115;345;251
1987;1988;12;VfL Bochum;34;30;-4;47;51;10;10;14;40;30;Bochum;51.4818∘N;7.2163∘O;578;532;-81;852;933;189;154;235;721;532
1987;1988;13;Borussia Dortmund;34;29;-3;51;54;9;11;14;38;29;Dortmund;51.5136∘N;7.4653∘O;706;707;40;1266;1226;271;165;270;978;707
1987;1988;14;1. FC Kaiserslautern;34;29;-9;53;62;11;7;16;40;29;Kaiserslautern;49.4444∘N;7.7778∘O;842;849;-14;1406;1420;324;201;317;1173;849
1987;1988;15;Karlsruher SC;34;29;-18;37;55;9;11;14;38;29;Karlsruhe;49.0069∘N;8.4037∘O;400;309;-276;538;814;103;103;194;412;309
1987;1988;16;Waldhof Mannheim;34;28;-15;35;50;7;14;13;35;28;Mannheim;49.4891∘N;8.4669∘O;170;157;-53;220;273;51;55;64;208;157
1987;1988;17;FC Homburg;34;24;-33;37;70;7;10;17;31;24;Homburg;49.3283∘N;7.3400∘O;68;45;-79;70;149;13;19;36;58;45
1987;1988;18;Schalke 04;34;23;-36;48;84;8;7;19;31;23;Gelsenkirchen;51.5167∘N;7.0500∘O;774;738;-117;1186;1303;283;172;319;1021;738
1988;1989;1;Bayern München;34;50;41;67;26;19;12;3;69;50;München;48.1372∘N;11.5755∘O;816;1091;803;1833;1030;453;185;178;1544;1091
1988;1989;2;1. FC Köln;34;45;28;58;30;18;9;7;63;45;Köln;50.9333∘N;6.9500∘O;876;1035;434;1689;1255;408;219;249;1443;1035
1988;1989;3;Werder Bremen;34;44;23;55;32;18;8;8;62;44;Bremen;53.0736∘N;8.8064∘O;842;923;175;1454;1279;362;199;281;1285;923
1988;1989;4;Hamburger SV;34;43;24;60;36;17;9;8;60;43;Hamburg;53.5511∘N;9.9937∘O;876;1009;359;1621;1262;394;221;261;1403;1009
1988;1989;5;VfB Stuttgart;34;39;9;58;49;16;7;11;55;39;Stuttgart;48.7833∘N;9.1833∘O;808;877;250;1475;1225;349;179;280;1226;877
1988;1989;6;Bor. Mönchengladbach;34;38;1;44;43;12;14;8;50;38;Mönchengladbach;51.1965∘N;6.4385∘O;816;976;503;1666;1163;383;210;223;1359;976
1988;1989;7;Borussia Dortmund;34;37;16;56;40;12;13;9;49;37;Dortmund;51.5136∘N;7.4653∘O;740;744;56;1322;1266;283;178;279;1027;744
1988;1989;8;Bayer Leverkusen;34;34;1;45;44;10;14;10;44;34;Leverkusen;51.0416∘N;7.0004∘O;340;326;-45;504;549;114;98;128;440;326
1988;1989;9;1. FC Kaiserslautern;34;33;3;47;44;10;13;11;43;33;Kaiserslautern;49.4444∘N;7.7778∘O;876;882;-11;1453;1464;334;214;328;1216;882
1988;1989;10;FC St. Pauli;34;32;-1;41;42;9;14;11;41;32;Hamburg;53.5511∘N;9.9937∘O;68;50;-43;85;128;15;20;33;65;50
1988;1989;11;Karlsruher SC;34;32;-3;48;51;12;8;14;44;32;Karlsruhe;49.0069∘N;8.4037∘O;434;341;-279;586;865;115;111;208;456;341
1988;1989;12;Waldhof Mannheim;34;31;-9;43;52;10;11;13;41;31;Mannheim;49.4891∘N;8.4669∘O;204;188;-62;263;325;61;66;77;249;188
1988;1989;13;Bayer Uerdingen;34;31;-10;50;60;10;11;13;41;31;Krefeld;51.3340∘N;6.5684∘O;306;282;-106;464;570;104;74;128;386;282
1988;1989;14;1. FC Nürnberg;34;26;-18;36;54;8;10;16;34;26;Nürnberg;49.4521∘N;11.0767∘O;502;459;-127;713;840;168;123;211;627;459
1988;1989;15;VfL Bochum;34;26;-20;37;57;9;8;17;35;26;Bochum;51.4818∘N;7.2163∘O;612;558;-101;889;990;198;162;252;756;558
1988;1989;16;Eintracht Frankfurt;34;26;-23;30;53;8;10;16;34;26;Frankfurt am Main;50.1109∘N;8.6821∘O;876;894;111;1519;1408;342;210;324;1236;894
1988;1989;17;Stuttgarter Kickers;34;26;-27;41;68;10;6;18;36;26;Stuttgart;48.7833∘N;9.1833∘O;34;26;-27;41;68;10;6;18;36;26
1988;1989;18;Hannover 96;34;19;-35;36;71;4;11;19;23;19;Hannover;52.3759∘N;9.7320∘O;472;392;-152;683;835;136;120;216;528;392
1989;1990;1;Bayern München;34;49;36;64;28;19;11;4;68;49;München;48.1372∘N;11.5755∘O;850;1140;839;1897;1058;472;196;182;1612;1140
1989;1990;2;1. FC Köln;34;43;10;54;44;17;9;8;60;43;Köln;50.9333∘N;6.9500∘O;910;1078;444;1743;1299;425;228;257;1503;1078
1989;1990;3;Eintracht Frankfurt;34;41;21;61;40;15;11;8;56;41;Frankfurt am Main;50.1109∘N;8.6821∘O;910;935;132;1580;1448;357;221;332;1292;935
1989;1990;4;Borussia Dortmund;34;41;16;51;35;15;11;8;56;41;Dortmund;51.5136∘N;7.4653∘O;774;785;72;1373;1301;298;189;287;1083;785
1989;1990;5;Bayer Leverkusen;34;39;8;40;32;12;15;7;51;39;Leverkusen;51.0416∘N;7.0004∘O;374;365;-37;544;581;126;113;135;491;365
1989;1990;6;VfB Stuttgart;34;36;6;53;47;15;6;13;51;36;Stuttgart;48.7833∘N;9.1833∘O;842;913;256;1528;1272;364;185;293;1277;913
1989;1990;7;Werder Bremen;34;34;8;49;41;10;14;10;44;34;Bremen;53.0736∘N;8.8064∘O;876;957;183;1503;1320;372;213;291;1329;957
1989;1990;8;1. FC Nürnberg;34;33;-4;42;46;11;11;12;44;33;Nürnberg;49.4521∘N;11.0767∘O;536;492;-131;755;886;179;134;223;671;492
1989;1990;9;Fortuna Düsseldorf;34;32;0;41;41;10;12;12;42;32;Düsseldorf;51.2217∘N;6.7761∘O;612;570;-133;974;1107;204;162;246;774;570
1989;1990;10;Karlsruher SC;34;32;-7;32;39;10;12;12;42;32;Karlsruhe;49.0069∘N;8.4037∘O;468;373;-286;618;904;125;123;220;498;373
1989;1990;11;Hamburger SV;34;31;-7;39;46;13;5;16;44;31;Hamburg;53.5511∘N;9.9937∘O;910;1040;352;1660;1308;407;226;277;1447;1040
1989;1990;12;1. FC Kaiserslautern;34;31;-13;42;55;10;11;13;41;31;Kaiserslautern;49.4444∘N;7.7778∘O;910;913;-24;1495;1519;344;225;341;1257;913
1989;1990;13;FC St. Pauli;34;31;-15;31;46;9;13;12;40;31;Hamburg;53.5511∘N;9.9937∘O;102;81;-58;116;174;24;33;45;105;81
1989;1990;14;Bayer Uerdingen;34;30;-7;41;48;10;10;14;40;30;Krefeld;51.3340∘N;6.5684∘O;340;312;-113;505;618;114;84;142;426;312
1989;1990;15;Bor. Mönchengladbach;34;30;-8;37;45;11;8;15;41;30;Mönchengladbach;51.1965∘N;6.4385∘O;850;1006;495;1703;1208;394;218;238;1400;1006
1989;1990;16;VfL Bochum;34;29;-9;44;53;11;7;16;40;29;Bochum;51.4818∘N;7.2163∘O;646;587;-110;933;1043;209;169;268;796;587
1989;1990;17;Waldhof Mannheim;34;26;-17;36;53;10;6;18;36;26;Mannheim;49.4891∘N;8.4669∘O;238;214;-79;299;378;71;72;95;285;214
1989;1990;18;FC Homburg;34;24;-18;33;51;8;8;18;32;24;Homburg;49.3283∘N;7.3400∘O;102;69;-97;103;200;21;27;54;90;69
1990;1991;1;1. FC Kaiserslautern;34;48;27;72;45;19;10;5;67;48;Kaiserslautern;49.4444∘N;7.7778∘O;944;961;3;1567;1564;363;235;346;1324;961
1990;1991;2;Bayern München;34;45;33;74;41;18;9;7;63;45;München;48.1372∘N;11.5755∘O;884;1185;872;1971;1099;490;205;189;1675;1185
1990;1991;3;Werder Bremen;34;42;17;46;29;14;14;6;56;42;Bremen;53.0736∘N;8.8064∘O;910;999;200;1549;1349;386;227;297;1385;999
1990;1991;4;Eintracht Frankfurt;34;40;23;63;40;15;10;9;55;40;Frankfurt am Main;50.1109∘N;8.6821∘O;944;975;155;1643;1488;372;231;341;1347;975
1990;1991;5;Hamburger SV;34;40;22;60;38;16;8;10;56;40;Hamburg;53.5511∘N;9.9937∘O;944;1080;374;1720;1346;423;234;287;1503;1080
1990;1991;6;VfB Stuttgart;34;38;13;57;44;14;10;10;52;38;Stuttgart;48.7833∘N;9.1833∘O;876;951;269;1585;1316;378;195;303;1329;951
1990;1991;7;1. FC Köln;34;37;7;50;43;13;11;10;50;37;Köln;50.9333∘N;6.9500∘O;944;1115;451;1793;1342;438;239;267;1553;1115
1990;1991;8;Bayer Leverkusen;34;35;1;47;46;11;13;10;46;35;Leverkusen;51.0416∘N;7.0004∘O;408;400;-36;591;627;137;126;145;537;400
1990;1991;9;Bor. Mönchengladbach;34;35;-5;49;54;9;17;8;44;35;Mönchengladbach;51.1965∘N;6.4385∘O;884;1041;490;1752;1262;403;235;246;1444;1041
1990;1991;10;Borussia Dortmund;34;34;-11;46;57;10;14;10;44;34;Dortmund;51.5136∘N;7.4653∘O;808;819;61;1419;1358;308;203;297;1127;819
1990;1991;11;Wattenscheid 09;34;33;-9;42;51;9;15;10;42;33;Bochum (Wattenscheid);51.4818∘N;7.2163∘O;34;33;-9;42;51;9;15;10;42;33
1990;1991;12;Fortuna Düsseldorf;34;32;-9;40;49;11;10;13;43;32;Düsseldorf;51.2217∘N;6.7761∘O;646;602;-142;1014;1156;215;172;259;817;602
1990;1991;13;Karlsruher SC;34;31;-6;46;52;8;15;11;39;31;Karlsruhe;49.0069∘N;8.4037∘O;502;404;-292;664;956;133;138;231;537;404
1990;1991;14;VfL Bochum;34;29;-2;50;52;9;11;14;38;29;Bochum;51.4818∘N;7.2163∘O;680;616;-112;983;1095;218;180;282;834;616
1990;1991;15;1. FC Nürnberg;34;29;-14;40;54;10;9;15;39;29;Nürnberg;49.4521∘N;11.0767∘O;570;521;-145;795;940;189;143;238;710;521
1990;1991;16;FC St. Pauli;34;27;-20;33;53;6;15;13;33;27;Hamburg;53.5511∘N;9.9937∘O;136;108;-78;149;227;30;48;58;138;108
1990;1991;17;Bayer Uerdingen;34;23;-20;34;54;5;13;16;28;23;Krefeld;51.3340∘N;6.5684∘O;374;335;-133;539;672;119;97;158;454;335
1990;1991;18;Hertha BSC Berlin;34;14;-47;37;84;3;8;23;17;14;Berlin;52.5200∘N;13.4050∘O;536;509;-103;794;897;186;137;213;695;509
1991;1992;1;VfB Stuttgart;38;52;30;62;32;21;10;7;73;52;Stuttgart;48.7833∘N;9.1833∘O;914;1003;299;1647;1348;399;205;310;1402;1003
1991;1992;2;Borussia Dortmund;38;52;19;66;47;20;12;6;72;52;Dortmund;51.5136∘N;7.4653∘O;846;871;80;1485;1405;328;215;303;1199;871
1991;1992;3;Eintracht Frankfurt;38;50;35;76;41;18;14;6;68;50;Frankfurt am Main;50.1109∘N;8.6821∘O;982;1025;190;1719;1529;390;245;347;1415;1025
1991;1992;4;1. FC Köln;38;44;17;58;41;13;18;7;57;44;Köln;50.9333∘N;6.9500∘O;982;1159;468;1851;1383;451;257;274;1610;1159
1991;1992;5;1. FC Kaiserslautern;38;44;16;58;42;17;10;11;61;44;Kaiserslautern;49.4444∘N;7.7778∘O;982;1005;19;1625;1606;380;245;357;1385;1005
1991;1992;6;Bayer Leverkusen;38;43;14;53;39;15;13;10;58;43;Leverkusen;51.0416∘N;7.0004∘O;446;443;-22;644;666;152;139;155;595;443
1991;1992;7;1. FC Nürnberg;38;43;3;54;51;18;7;13;61;43;Nürnberg;49.4521∘N;11.0767∘O;608;564;-142;849;991;207;150;251;771;564
1991;1992;8;Karlsruher SC;38;41;-2;48;50;16;9;13;57;41;Karlsruhe;49.0069∘N;8.4037∘O;540;445;-294;712;1006;149;147;244;594;445
1991;1992;9;Werder Bremen;38;38;-1;44;45;11;16;11;49;38;Bremen;53.0736∘N;8.8064∘O;948;1037;199;1593;1394;397;243;308;1434;1037
1991;1992;10;Bayern München;38;36;-2;59;61;13;10;15;49;36;München;48.1372∘N;11.5755∘O;922;1221;870;2030;1160;503;215;204;1724;1221
1991;1992;11;Schalke 04;38;34;0;45;45;11;12;15;45;34;Gelsenkirchen;51.5167∘N;7.0500∘O;812;772;-117;1231;1348;294;184;334;1066;772
1991;1992;12;Hamburger SV;38;34;-11;32;43;9;16;13;43;34;Hamburg;53.5511∘N;9.9937∘O;982;1114;363;1752;1389;432;250;300;1546;1114
1991;1992;13;Bor. Mönchengladbach;38;34;-12;37;49;10;14;14;44;34;Mönchengladbach;51.1965∘N;6.4385∘O;922;1075;478;1789;1311;413;249;260;1488;1075
1991;1992;14;Dynamo Dresden;38;34;-16;34;50;12;10;16;46;34;Dresden;51.0504∘N;13.7373∘O;38;34;-16;34;50;12;10;16;46;34
1991;1992;15;VfL Bochum;38;33;-17;38;55;10;13;15;43;33;Bochum;51.4818∘N;7.2163∘O;718;649;-129;1021;1150;228;193;297;877;649
1991;1992;16;Wattenscheid 09;38;32;-10;50;60;9;14;15;41;32;Bochum (Wattenscheid);51.4818∘N;7.2163∘O;72;65;-19;92;111;18;29;25;83;65
1991;1992;17;Stuttgarter Kickers;38;31;-11;53;64;10;11;17;41;31;Stuttgart;48.7833∘N;9.1833∘O;72;57;-38;94;132;20;17;35;77;57
1991;1992;18;Hansa Rostock;38;31;-12;43;55;10;11;17;41;31;Rostock;54.0924∘N;12.1287∘O;38;31;-12;43;55;10;11;17;41;31
1991;1992;19;MSV Duisburg;38;30;-12;43;55;7;16;15;37;30;Duisburg;51.4333∘N;6.7667∘O;676;632;-100;977;1077;223;186;267;855;632
1991;1992;20;Fortuna Düsseldorf;38;24;-28;41;69;6;12;20;30;24;Düsseldorf;51.2217∘N;6.7761∘O;684;626;-170;1055;1225;221;184;279;847;626
1992;1993;1;Werder Bremen;34;48;33;63;30;19;10;5;67;48;Bremen;53.0736∘N;8.8064∘O;982;1085;232;1656;1424;416;253;313;1501;1085
1992;1993;2;Bayern München;34;47;29;74;45;18;11;5;65;47;München;48.1372∘N;11.5755∘O;956;1268;899;2104;1205;521;226;209;1789;1268
1992;1993;3;Eintracht Frankfurt;34;42;17;56;39;15;12;7;57;42;Frankfurt am Main;50.1109∘N;8.6821∘O;1016;1067;207;1775;1568;405;257;354;1472;1067
1992;1993;4;Borussia Dortmund;34;41;18;61;43;18;5;11;59;41;Dortmund;51.5136∘N;7.4653∘O;880;912;98;1546;1448;346;220;314;1258;912
1992;1993;5;Bayer Leverkusen;34;40;19;64;45;14;12;8;54;40;Leverkusen;51.0416∘N;7.0004∘O;480;483;-3;708;711;166;151;163;649;483
1992;1993;6;Karlsruher SC;34;39;6;60;54;14;11;9;53;39;Karlsruhe;49.0069∘N;8.4037∘O;574;484;-288;772;1060;163;158;253;647;484
1992;1993;7;VfB Stuttgart;34;36;6;56;50;12;12;10;48;36;Stuttgart;48.7833∘N;9.1833∘O;948;1039;305;1703;1398;411;217;320;1450;1039
1992;1993;8;1. FC Kaiserslautern;34;35;10;50;40;13;9;12;48;35;Kaiserslautern;49.4444∘N;7.7778∘O;1016;1040;29;1675;1646;393;254;369;1433;1040
1992;1993;9;Bor. Mönchengladbach;34;35;0;59;59;13;9;12;48;35;Mönchengladbach;51.1965∘N;6.4385∘O;956;1110;478;1848;1370;426;258;272;1536;1110
1992;1993;10;Schalke 04;34;34;-1;42;43;11;12;11;45;34;Gelsenkirchen;51.5167∘N;7.0500∘O;846;806;-118;1273;1391;305;196;345;1111;806
1992;1993;11;Hamburger SV;34;31;-2;42;44;8;15;11;39;31;Hamburg;53.5511∘N;9.9937∘O;1016;1145;361;1794;1433;440;265;311;1585;1145
1992;1993;12;1. FC Köln;34;28;-10;41;51;12;4;18;40;28;Köln;50.9333∘N;6.9500∘O;1016;1187;458;1892;1434;463;261;292;1650;1187
1992;1993;13;1. FC Nürnberg;34;28;-17;30;47;10;8;16;38;28;Nürnberg;49.4521∘N;11.0767∘O;642;592;-159;879;1038;217;158;267;809;592
1992;1993;14;Wattenscheid 09;34;28;-21;46;67;10;8;16;38;28;Bochum (Wattenscheid);51.4818∘N;7.2163∘O;106;93;-40;138;178;28;37;41;121;93
1992;1993;15;Dynamo Dresden;34;27;-17;32;49;7;13;14;34;27;Dresden;51.0504∘N;13.7373∘O;72;61;-33;66;99;19;23;30;80;61
1992;1993;16;VfL Bochum;34;26;-7;45;52;8;10;16;34;26;Bochum;51.4818∘N;7.2163∘O;752;675;-136;1066;1202;236;203;313;911;675
1992;1993;17;Bayer Uerdingen;34;24;-29;35;64;7;10;17;31;24;Krefeld;51.3340∘N;6.5684∘O;408;359;-162;574;736;126;107;175;485;359
1992;1993;18;1. FC Saarbrücken;34;23;-34;37;71;5;13;16;28;23;Saarbrücken;49.2333∘N;7.0000∘O;166;112;-134;202;336;32;48;86;144;112
1993;1994;1;Bayern München;34;44;31;68;37;17;10;7;61;44;München;48.1372∘N;11.5755∘O;990;1312;930;2172;1242;538;236;216;1850;1312
1993;1994;2;1. FC Kaiserslautern;34;43;28;64;36;18;7;9;61;43;Kaiserslautern;49.4444∘N;7.7778∘O;1050;1083;57;1739;1682;411;261;378;1494;1083
1993;1994;3;Bayer Leverkusen;34;39;13;60;47;14;11;9;53;39;Leverkusen;51.0416∘N;7.0004∘O;514;522;10;768;758;180;162;172;702;522
1993;1994;4;Borussia Dortmund;34;39;4;49;45;15;9;10;54;39;Dortmund;51.5136∘N;7.4653∘O;914;951;102;1595;1493;361;229;324;1312;951
1993;1994;5;Eintracht Frankfurt;34;38;16;57;41;15;8;11;53;38;Frankfurt am Main;50.1109∘N;8.6821∘O;1050;1105;223;1832;1609;420;265;365;1525;1105
1993;1994;6;Karlsruher SC;34;38;3;46;43;14;10;10;52;38;Karlsruhe;49.0069∘N;8.4037∘O;608;522;-285;818;1103;177;168;263;699;522
1993;1994;7;VfB Stuttgart;34;37;8;51;43;13;11;10;50;37;Stuttgart;48.7833∘N;9.1833∘O;982;1076;313;1754;1441;424;228;330;1500;1076
1993;1994;8;Werder Bremen;34;36;7;51;44;13;10;11;49;36;Bremen;53.0736∘N;8.8064∘O;1016;1121;239;1707;1468;429;263;324;1550;1121
1993;1994;9;MSV Duisburg;34;36;-11;41;52;14;8;12;50;36;Duisburg;51.4333∘N;6.7667∘O;710;668;-111;1018;1129;237;194;279;905;668
1993;1994;10;Bor. Mönchengladbach;34;35;6;65;59;14;7;13;49;35;Mönchengladbach;51.1965∘N;6.4385∘O;990;1145;484;1913;1429;440;265;285;1585;1145
1993;1994;11;1. FC Köln;34;34;-2;49;51;14;6;14;48;34;Köln;50.9333∘N;6.9500∘O;1050;1221;456;1941;1485;477;267;306;1698;1221
1993;1994;12;Hamburger SV;34;34;-4;48;52;13;8;13;47;34;Hamburg;53.5511∘N;9.9937∘O;1050;1179;357;1842;1485;453;273;324;1632;1179
1993;1994;13;Dynamo Dresden;34;30;-11;33;44;10;14;10;44;34;Dresden;51.0504∘N;13.7373∘O;106;91;-44;99;143;29;37;40;124;95
1993;1994;14;Schalke 04;34;29;-12;38;50;10;9;15;39;29;Gelsenkirchen;51.5167∘N;7.0500∘O;880;835;-130;1311;1441;315;205;360;1150;835
1993;1994;15;SC Freiburg;34;28;-3;54;57;10;8;16;38;28;Freiburg im Breisgau;47.9990∘N;7.8421∘O;34;28;-3;54;57;10;8;16;38;28
1993;1994;16;1. FC Nürnberg;34;28;-14;41;55;10;8;16;38;28;Nürnberg;49.4521∘N;11.0767∘O;676;620;-173;920;1093;227;166;283;847;620
1993;1994;17;Wattenscheid 09;34;23;-22;48;70;6;11;17;29;23;Bochum (Wattenscheid);51.4818∘N;7.2163∘O;140;116;-62;186;248;34;48;58;150;116
1993;1994;18;VfB Leipzig;34;17;-37;32;69;3;11;20;20;17;Leipzig;51.3397∘N;12.3731∘O;34;17;-37;32;69;3;11;20;20;17
1994;1995;1;Borussia Dortmund;34;69;34;67;33;20;9;5;69;49;Dortmund;51.5136∘N;7.4653∘O;948;1020;136;1662;1526;381;238;329;1381;1000
1994;1995;2;Werder Bremen;34;68;31;70;39;20;8;6;68;48;Bremen;53.0736∘N;8.8064∘O;1050;1189;270;1777;1507;449;271;330;1618;1169
1994;1995;3;SC Freiburg;34;66;22;66;44;20;6;8;66;46;Freiburg im Breisgau;47.9990∘N;7.8421∘O;68;94;19;120;101;30;14;24;104;74
1994;1995;4;1. FC Kaiserslautern;34;63;17;58;41;17;12;5;63;46;Kaiserslautern;49.4444∘N;7.7778∘O;1084;1146;74;1797;1723;428;273;383;1557;1129
1994;1995;5;Bor. Mönchengladbach;34;60;25;66;41;17;9;8;60;43;Mönchengladbach;51.1965∘N;6.4385∘O;1024;1205;509;1979;1470;457;274;293;1645;1188
1994;1995;6;Bayern München;34;58;14;55;41;15;13;6;58;43;München;48.1372∘N;11.5755∘O;1024;1370;944;2227;1283;553;249;222;1908;1355
1994;1995;7;Bayer Leverkusen;34;49;11;62;51;13;10;11;49;36;Leverkusen;51.0416∘N;7.0004∘O;548;571;21;830;809;193;172;183;751;558
1994;1995;8;Karlsruher SC;34;47;4;51;47;11;14;9;47;36;Karlsruhe;49.0069∘N;8.4037∘O;642;569;-281;869;1150;188;182;272;746;558
1994;1995;9;Eintracht Frankfurt;34;45;-8;41;49;12;9;13;45;33;Frankfurt am Main;50.1109∘N;8.6821∘O;1084;1150;215;1873;1658;432;274;378;1570;1138
1994;1995;10;1. FC Köln;34;43;0;54;54;11;10;13;43;32;Köln;50.9333∘N;6.9500∘O;1084;1264;456;1995;1539;488;277;319;1741;1253
1994;1995;11;Schalke 04;34;41;-6;48;54;10;11;13;41;31;Gelsenkirchen;51.5167∘N;7.0500∘O;914;876;-136;1359;1495;325;216;373;1191;866
1994;1995;12;VfB Stuttgart;34;40;-14;52;66;10;10;14;40;30;Stuttgart;48.7833∘N;9.1833∘O;1016;1116;299;1806;1507;434;238;344;1540;1106
1994;1995;13;Hamburger SV;34;39;-7;43;50;10;9;15;39;29;Hamburg;53.5511∘N;9.9937∘O;1084;1218;350;1885;1535;463;282;339;1671;1208
1994;1995;14;1860 München;34;35;-16;41;57;8;11;15;35;27;München;48.1372∘N;11.5755∘O;366;361;11;589;578;131;91;144;484;353
1994;1995;15;Bayer Uerdingen;34;32;-15;37;52;7;11;16;32;25;Krefeld;51.3340∘N;6.5684∘O;442;391;-177;611;788;133;118;191;517;384
1994;1995;16;VfL Bochum;34;31;-24;43;67;9;4;21;31;22;Bochum;51.4818∘N;7.2163∘O;786;706;-160;1109;1269;245;207;334;942;697
1994;1995;17;MSV Duisburg;34;26;-33;31;64;6;8;20;26;20;Duisburg;51.4333∘N;6.7667∘O;744;694;-144;1049;1193;243;202;299;931;688
1994;1995;18;Dynamo Dresden;34;20;-35;33;68;4;8;22;20;16;Dresden;51.0504∘N;13.7373∘O;140;111;-79;132;211;33;45;62;144;111
1995;1996;1;Borussia Dortmund;34;68;38;76;38;19;11;4;68;49;Dortmund;51.5136∘N;7.4653∘O;982;1088;174;1738;1564;400;249;333;1449;1049
1995;1996;2;Bayern München;34;62;20;66;46;19;5;10;62;43;München;48.1372∘N;11.5755∘O;1058;1432;964;2293;1329;572;254;232;1970;1398
1995;1996;3;Schalke 04;34;56;9;45;36;14;14;6;56;42;Gelsenkirchen;51.5167∘N;7.0500∘O;948;932;-127;1404;1531;339;230;379;1247;908
1995;1996;4;Bor. Mönchengladbach;34;53;1;52;51;15;8;11;53;38;Mönchengladbach;51.1965∘N;6.4385∘O;1058;1258;510;2031;1521;472;282;304;1698;1226
1995;1996;5;Hamburger SV;34;50;5;52;47;12;14;8;50;38;Hamburg;53.5511∘N;9.9937∘O;1118;1268;355;1937;1582;475;296;347;1721;1246
1995;1996;6;Hansa Rostock;34;49;4;47;43;13;10;11;49;36;Rostock;54.0924∘N;12.1287∘O;72;80;-8;90;98;23;21;28;90;67
1995;1996;7;Karlsruher SC;34;48;6;53;47;12;12;10;48;36;Karlsruhe;49.0069∘N;8.4037∘O;676;617;-275;922;1197;200;194;282;794;594
1995;1996;8;1860 München;34;45;6;52;46;11;12;11;45;34;München;48.1372∘N;11.5755∘O;400;406;17;641;624;142;103;155;529;387
1995;1996;9;Werder Bremen;34;44;-3;39;42;10;14;10;44;34;Bremen;53.0736∘N;8.8064∘O;1084;1233;267;1816;1549;459;285;340;1662;1203
1995;1996;10;VfB Stuttgart;34;43;-3;59;62;10;13;11;43;33;Stuttgart;48.7833∘N;9.1833∘O;1050;1159;296;1865;1569;444;251;355;1583;1139
1995;1996;11;SC Freiburg;34;42;-11;30;41;11;9;14;42;31;Freiburg im Breisgau;47.9990∘N;7.8421∘O;102;136;8;150;142;41;23;38;146;105
1995;1996;12;1. FC Köln;34;40;-2;33;35;9;13;12;40;31;Köln;50.9333∘N;6.9500∘O;1118;1304;454;2028;1574;497;290;331;1781;1284
1995;1996;13;Fortuna Düsseldorf;34;40;-7;40;47;8;16;10;40;32;Düsseldorf;51.2217∘N;6.7761∘O;718;666;-177;1095;1272;229;200;289;887;658
1995;1996;14;Bayer Leverkusen;34;38;-1;37;38;8;14;12;38;30;Leverkusen;51.0416∘N;7.0004∘O;582;609;20;867;847;201;186;195;789;588
1995;1996;15;FC St. Pauli;34;38;-8;43;51;9;11;14;38;29;Hamburg;53.5511∘N;9.9937∘O;170;146;-86;192;278;39;59;72;176;137
1995;1996;16;1. FC Kaiserslautern;34;36;-6;31;37;6;18;10;36;30;Kaiserslautern;49.4444∘N;7.7778∘O;1118;1182;68;1828;1760;434;291;393;1593;1159
1995;1996;17;Eintracht Frankfurt;34;32;-25;43;68;7;11;16;32;25;Frankfurt am Main;50.1109∘N;8.6821∘O;1118;1182;190;1916;1726;439;285;394;1602;1163
1995;1996;18;Bayer Uerdingen;34;26;-23;33;56;5;11;18;26;21;Krefeld;51.3340∘N;6.5684∘O;476;417;-200;644;844;138;129;209;543;405
1996;1997;1;Bayern München;34;71;34;68;34;20;11;3;71;51;München;48.1372∘N;11.5755∘O;1092;1503;998;2361;1363;592;265;235;2041;1449
1996;1997;2;Bayer Leverkusen;34;69;28;69;41;21;6;7;69;48;Leverkusen;51.0416∘N;7.0004∘O;616;678;48;936;888;222;192;202;858;636
1996;1997;3;Borussia Dortmund;34;63;22;63;41;19;6;9;63;44;Dortmund;51.5136∘N;7.4653∘O;1016;1151;196;1801;1605;419;255;342;1512;1093
1996;1997;4;VfB Stuttgart;34;61;38;78;40;18;7;9;61;43;Stuttgart;48.7833∘N;9.1833∘O;1084;1220;334;1943;1609;462;258;364;1644;1182
1996;1997;5;VfL Bochum;34;53;3;54;51;14;11;9;53;39;Bochum;51.4818∘N;7.2163∘O;820;759;-157;1163;1320;259;218;343;995;736
1996;1997;6;Karlsruher SC;34;49;11;55;44;13;10;11;49;36;Karlsruhe;49.0069∘N;8.4037∘O;710;666;-264;977;1241;213;204;293;843;630
1996;1997;7;1860 München;34;49;0;56;56;13;10;11;49;36;München;48.1372∘N;11.5755∘O;434;455;17;697;680;155;113;166;578;423
1996;1997;8;Werder Bremen;34;48;1;53;52;14;6;14;48;34;Bremen;53.0736∘N;8.8064∘O;1118;1281;268;1869;1601;473;291;354;1710;1237
1996;1997;9;MSV Duisburg;34;45;-5;44;49;12;9;13;45;33;Duisburg;51.4333∘N;6.7667∘O;778;739;-149;1093;1242;255;211;312;976;721
1996;1997;10;1. FC Köln;34;44;0;62;62;13;5;16;44;31;Köln;50.9333∘N;6.9500∘O;1152;1348;454;2090;1636;510;295;347;1825;1315
1996;1997;11;Bor. Mönchengladbach;34;43;-2;46;48;12;7;15;43;31;Mönchengladbach;51.1965∘N;6.4385∘O;1092;1301;508;2077;1569;484;289;319;1741;1257
1996;1997;12;Schalke 04;34;43;-5;35;40;11;10;13;43;32;Gelsenkirchen;51.5167∘N;7.0500∘O;982;975;-132;1439;1571;350;240;392;1290;940
1996;1997;13;Hamburger SV;34;41;-14;46;60;10;11;13;41;31;Hamburg;53.5511∘N;9.9937∘O;1152;1309;341;1983;1642;485;307;360;1762;1277
1996;1997;14;Arminia Bielefeld;34;40;-8;46;54;11;7;16;40;29;Bielefeld;52.0211∘N;8.5342∘O;306;244;-146;388;534;86;61;146;319;233
1996;1997;15;Hansa Rostock;34;40;-11;35;46;11;7;16;40;29;Rostock;54.0924∘N;12.1287∘O;106;120;-19;125;144;34;28;44;130;96
1996;1997;16;Fortuna Düsseldorf;34;33;-31;26;57;9;6;19;33;24;Düsseldorf;51.2217∘N;6.7761∘O;752;699;-208;1121;1329;238;206;308;920;682
1996;1997;17;SC Freiburg;34;29;-24;43;67;8;5;21;29;21;Freiburg im Breisgau;47.9990∘N;7.8421∘O;136;165;-16;193;209;49;28;59;175;126
1996;1997;18;FC St. Pauli;34;27;-37;32;69;7;6;21;27;20;Hamburg;53.5511∘N;9.9937∘O;204;173;-123;224;347;46;65;93;203;157
1997;1998;1;1. FC Kaiserslautern;34;68;24;63;39;19;11;4;68;49;Kaiserslautern;49.4444∘N;7.7778∘O;1152;1250;92;1891;1799;453;302;397;1661;1208
1997;1998;2;Bayern München;34;66;32;69;37;19;9;6;66;47;München;48.1372∘N;11.5755∘O;1126;1569;1030;2430;1400;611;274;241;2107;1496
1997;1998;3;Bayer Leverkusen;34;55;27;66;39;14;13;7;55;41;Leverkusen;51.0416∘N;7.0004∘O;650;733;75;1002;927;236;205;209;913;677
1997;1998;4;VfB Stuttgart;34;52;6;55;49;14;10;10;52;38;Stuttgart;48.7833∘N;9.1833∘O;1118;1272;340;1998;1658;476;268;374;1696;1220
1997;1998;5;Schalke 04;34;52;6;38;32;13;13;8;52;39;Gelsenkirchen;51.5167∘N;7.0500∘O;1016;1027;-126;1477;1603;363;253;400;1342;979
1997;1998;6;Hansa Rostock;34;51;8;54;46;14;9;11;51;37;Rostock;54.0924∘N;12.1287∘O;140;171;-11;179;190;48;37;55;181;133
1997;1998;7;Werder Bremen;34;50;-4;43;47;14;8;12;50;36;Bremen;53.0736∘N;8.8064∘O;1152;1331;264;1912;1648;487;299;366;1760;1273
1997;1998;8;MSV Duisburg;34;44;-1;43;44;11;11;12;44;33;Duisburg;51.4333∘N;6.7667∘O;812;783;-150;1136;1286;266;222;324;1020;754
1997;1998;9;Hamburger SV;34;44;-8;38;46;11;11;12;44;33;Hamburg;53.5511∘N;9.9937∘O;1186;1353;333;2021;1688;496;318;372;1806;1310
1997;1998;10;Borussia Dortmund;34;43;2;57;55;11;10;13;43;32;Dortmund;51.5136∘N;7.4653∘O;1050;1194;198;1858;1660;430;265;355;1555;1125
1997;1998;11;Hertha BSC Berlin;34;43;-12;41;53;12;7;15;43;31;Berlin;52.5200∘N;13.4050∘O;570;552;-115;835;950;198;144;228;738;540
1997;1998;12;VfL Bochum;34;41;-8;41;49;11;8;15;41;30;Bochum;51.4818∘N;7.2163∘O;854;800;-165;1204;1369;270;226;358;1036;766
1997;1998;13;1860 München;34;41;-11;43;54;11;8;15;41;30;München;48.1372∘N;11.5755∘O;468;496;6;740;734;166;121;181;619;453
1997;1998;14;VfL Wolfsburg;34;39;-16;38;54;11;6;17;39;28;Wolfsburg;52.4237∘N;10.7865∘O;34;39;-16;38;54;11;6;17;39;28
1997;1998;15;Bor. Mönchengladbach;34;38;-5;54;59;9;11;14;38;29;Mönchengladbach;51.1965∘N;6.4385∘O;1126;1339;503;2131;1628;493;300;333;1779;1286
1997;1998;16;Karlsruher SC;34;38;-12;48;60;9;11;14;38;29;Karlsruhe;49.0069∘N;8.4037∘O;744;704;-276;1025;1301;222;215;307;881;659
1997;1998;17;1. FC Köln;34;36;-15;49;64;10;6;18;36;26;Köln;50.9333∘N;6.9500∘O;1186;1384;439;2139;1700;520;301;365;1861;1341
1997;1998;18;Arminia Bielefeld;34;32;-13;43;56;8;8;18;32;24;Bielefeld;52.0211∘N;8.5342∘O;340;276;-159;431;590;94;69;164;351;257
1998;1999;1;Bayern München;34;78;48;76;28;24;6;4;78;54;München;48.1372∘N;11.5755∘O;1160;1647;1078;2506;1428;635;280;245;2185;1550
1998;1999;2;Bayer Leverkusen;34;63;31;61;30;17;12;5;63;46;Leverkusen;51.0416∘N;7.0004∘O;684;796;106;1063;957;253;217;214;976;723
1998;1999;3;Hertha BSC Berlin;34;62;27;59;32;18;8;8;62;44;Berlin;52.5200∘N;13.4050∘O;604;614;-88;894;982;216;152;236;800;584
1998;1999;4;Borussia Dortmund;34;57;14;48;34;16;9;9;57;41;Dortmund;51.5136∘N;7.4653∘O;1084;1251;212;1906;1694;446;274;364;1612;1166
1998;1999;5;1. FC Kaiserslautern;34;57;4;51;47;17;6;11;57;40;Kaiserslautern;49.4444∘N;7.7778∘O;1186;1307;96;1942;1846;470;308;408;1718;1248
1998;1999;6;VfL Wolfsburg;34;55;5;54;49;15;10;9;55;40;Wolfsburg;52.4237∘N;10.7865∘O;68;94;-11;92;103;26;16;26;94;68
1998;1999;7;Hamburger SV;34;50;1;47;46;13;11;10;50;37;Hamburg;53.5511∘N;9.9937∘O;1220;1403;334;2068;1734;509;329;382;1856;1347
1998;1999;8;MSV Duisburg;34;49;3;48;45;13;10;11;49;36;Duisburg;51.4333∘N;6.7667∘O;846;832;-147;1184;1331;279;232;335;1069;790
1998;1999;9;1860 München;34;41;-7;49;56;11;8;15;41;30;München;48.1372∘N;11.5755∘O;502;537;-1;789;790;177;129;196;660;483
1998;1999;10;Schalke 04;34;41;-13;41;54;10;11;13;41;31;Gelsenkirchen;51.5167∘N;7.0500∘O;1050;1068;-139;1518;1657;373;264;413;1383;1010
1998;1999;11;VfB Stuttgart;34;39;-7;41;48;9;12;13;39;30;Stuttgart;48.7833∘N;9.1833∘O;1152;1311;333;2039;1706;485;280;387;1735;1250
1998;1999;12;SC Freiburg;34;39;-8;36;44;10;9;15;39;29;Freiburg im Breisgau;47.9990∘N;7.8421∘O;170;204;-24;229;253;59;37;74;214;155
1998;1999;13;Werder Bremen;34;38;-6;41;47;10;8;16;38;28;Bremen;53.0736∘N;8.8064∘O;1186;1369;258;1953;1695;497;307;382;1798;1301
1998;1999;14;Hansa Rostock;34;38;-9;49;58;9;11;14;38;29;Rostock;54.0924∘N;12.1287∘O;174;209;-20;228;248;57;48;69;219;162
1998;1999;15;Eintracht Frankfurt;34;37;-10;44;54;9;10;15;37;28;Frankfurt am Main;50.1109∘N;8.6821∘O;1152;1219;180;1960;1780;448;295;409;1639;1191
1998;1999;16;1. FC Nürnberg;34;37;-10;40;50;7;16;11;37;30;Nürnberg;49.4521∘N;11.0767∘O;710;657;-183;960;1143;234;182;294;884;650
1998;1999;17;VfL Bochum;34;29;-25;40;65;7;8;19;29;22;Bochum;51.4818∘N;7.2163∘O;888;829;-190;1244;1434;277;234;377;1065;788
1998;1999;18;Bor. Mönchengladbach;34;21;-38;41;79;4;9;21;21;17;Mönchengladbach;51.1965∘N;6.4385∘O;1160;1360;465;2172;1707;497;309;354;1800;1303
1999;2000;1;Bayern München;34;73;45;73;28;22;7;5;73;51;München;48.1372∘N;11.5755∘O;1194;1720;1123;2579;1456;657;287;250;2258;1601
1999;2000;2;Bayer Leverkusen;34;73;38;74;36;21;10;3;73;52;Leverkusen;51.0416∘N;7.0004∘O;718;869;144;1137;993;274;227;217;1049;775
1999;2000;3;Hamburger SV;34;59;24;63;39;16;11;7;59;43;Hamburg;53.5511∘N;9.9937∘O;1254;1462;358;2131;1773;525;340;389;1915;1390
1999;2000;4;1860 München;34;53;7;55;48;14;11;9;53;39;München;48.1372∘N;11.5755∘O;536;590;6;844;838;191;140;205;713;522
1999;2000;5;1. FC Kaiserslautern;34;50;-5;54;59;15;5;14;50;35;Kaiserslautern;49.4444∘N;7.7778∘O;1220;1357;91;1996;1905;485;313;422;1768;1283
1999;2000;6;Hertha BSC Berlin;34;50;-7;39;46;13;11;10;50;37;Berlin;52.5200∘N;13.4050∘O;638;664;-95;933;1028;229;163;246;850;621
1999;2000;7;VfL Wolfsburg;34;49;-7;51;58;12;13;9;49;37;Wolfsburg;52.4237∘N;10.7865∘O;102;143;-18;143;161;38;29;35;143;105
1999;2000;8;VfB Stuttgart;34;48;-3;44;47;14;6;14;48;34;Stuttgart;48.7833∘N;9.1833∘O;1186;1359;330;2083;1753;499;286;401;1783;1284
1999;2000;9;Werder Bremen;34;47;13;65;52;13;8;13;47;34;Bremen;53.0736∘N;8.8064∘O;1220;1416;271;2018;1747;510;315;395;1845;1335
1999;2000;10;SpVgg Unterhaching;34;44;-2;40;42;12;8;14;44;32;Unterhaching (München);48.0667∘N;11.6000∘O;34;44;-2;40;42;12;8;14;44;32
1999;2000;11;Borussia Dortmund;34;40;3;41;38;9;13;12;40;31;Dortmund;51.5136∘N;7.4653∘O;1118;1291;215;1947;1732;455;287;376;1652;1197
1999;2000;12;SC Freiburg;34;40;-5;45;50;10;10;14;40;30;Freiburg im Breisgau;47.9990∘N;7.8421∘O;204;244;-29;274;303;69;47;88;254;185
1999;2000;13;Schalke 04;34;39;-2;42;44;8;15;11;39;31;Gelsenkirchen;51.5167∘N;7.0500∘O;1084;1107;-141;1560;1701;381;279;424;1422;1041
1999;2000;14;Eintracht Frankfurt;34;39;-2;42;44;12;5;17;41;29;Frankfurt am Main;50.1109∘N;8.6821∘O;1186;1258;178;2002;1824;460;300;426;1680;1220
1999;2000;15;Hansa Rostock;34;38;-16;44;60;8;14;12;38;30;Rostock;54.0924∘N;12.1287∘O;208;247;-36;272;308;65;62;81;257;192
1999;2000;16;SSV Ulm 46;34;35;-26;36;62;9;8;17;35;26;Ulm;48.4011∘N;9.9876∘O;34;35;-26;36;62;9;8;17;35;26
1999;2000;17;Arminia Bielefeld;34;30;-21;40;61;7;9;18;30;23;Bielefeld;52.0211∘N;8.5342∘O;374;306;-180;471;651;101;78;182;381;280
1999;2000;18;MSV Duisburg ;34;22;-34;37;71;4;10;20;22;18;Duisburg;51.4333∘N;6.7667∘O;34;22;-34;37;71;4;10;20;22;18
2000;2001;1;Bayern München;34;63;25;62;37;19;6;9;63;44;München;48.1372∘N;11.5755∘O;1228;1783;1148;2641;1493;676;293;259;2321;1645
2000;2001;2;Schalke 04;34;62;30;65;35;18;8;8;62;44;Gelsenkirchen;51.5167∘N;7.0500∘O;1118;1169;-111;1625;1736;399;287;432;1484;1085
2000;2001;3;Borussia Dortmund;34;58;20;62;42;16;10;8;58;42;Dortmund;51.5136∘N;7.4653∘O;1152;1349;235;2009;1774;471;297;384;1710;1239
2000;2001;4;Bayer Leverkusen;34;57;14;54;40;17;6;11;57;40;Leverkusen;51.0416∘N;7.0004∘O;752;926;158;1191;1033;291;233;228;1106;815
2000;2001;5;Hertha BSC Berlin;34;56;6;58;52;18;2;14;56;38;Berlin;52.5200∘N;13.4050∘O;672;720;-89;991;1080;247;165;260;906;659
2000;2001;6;SC Freiburg;34;55;17;54;37;15;10;9;55;40;Freiburg im Breisgau;47.9990∘N;7.8421∘O;238;299;-12;328;340;84;57;97;309;225
2000;2001;7;Werder Bremen;34;53;5;53;48;15;8;11;53;38;Bremen;53.0736∘N;8.8064∘O;1254;1469;276;2071;1795;525;323;406;1898;1373
2000;2001;8;1. FC Kaiserslautern;34;50;-5;49;54;15;5;14;50;35;Kaiserslautern;49.4444∘N;7.7778∘O;1254;1407;86;2045;1959;500;318;436;1818;1318
2000;2001;9;VfL Wolfsburg;34;47;15;60;45;12;11;11;47;35;Wolfsburg;52.4237∘N;10.7865∘O;136;190;-3;203;206;50;40;46;190;140
2000;2001;10;1. FC Köln;34;46;7;59;52;12;10;12;46;34;Köln;50.9333∘N;6.9500∘O;1220;1430;446;2198;1752;532;311;377;1907;1375
2000;2001;11;1860 München;34;44;-12;43;55;12;8;14;44;32;München;48.1372∘N;11.5755∘O;570;634;-6;887;893;203;148;219;757;554
2000;2001;12;Hansa Rostock;34;43;-13;34;47;12;7;15;43;31;Rostock;54.0924∘N;12.1287∘O;242;290;-49;306;355;77;69;96;300;223
2000;2001;13;Hamburger SV;34;41;0;58;58;10;11;13;41;31;Hamburg;53.5511∘N;9.9937∘O;1288;1503;358;2189;1831;535;351;402;1956;1421
2000;2001;14;Energie Cottbus;34;39;-14;38;52;12;3;19;39;27;Cottbus;51.7516∘N;14.3364∘O;34;39;-14;38;52;12;3;19;39;27
2000;2001;15;VfB Stuttgart;34;38;-7;42;49;9;11;14;38;29;Stuttgart;48.7833∘N;9.1833∘O;1220;1397;323;2125;1802;508;297;415;1821;1313
2000;2001;16;SpVgg Unterhaching;34;35;-24;35;59;8;11;15;35;27;Unterhaching (München);48.0667∘N;11.6000∘O;68;79;-26;75;101;20;19;29;79;59
2000;2001;17;Eintracht Frankfurt;34;35;-27;41;68;10;5;19;35;25;Frankfurt am Main;50.1109∘N;8.6821∘O;1220;1293;151;2043;1892;470;305;445;1715;1245
2000;2001;18;VfL Bochum;34;27;-37;30;67;7;6;21;27;20;Bochum;51.4818∘N;7.2163∘O;922;856;-227;1274;1501;284;240;398;1092;808
2001;2002;1;Borussia Dortmund;34;70;29;62;33;21;7;6;70;49;Dortmund;51.5136∘N;7.4653∘O;1186;1419;264;2071;1807;492;304;390;1780;1288
2001;2002;2;Bayer Leverkusen;34;69;39;77;38;21;6;7;69;48;Leverkusen;51.0416∘N;7.0004∘O;786;995;197;1268;1071;312;239;235;1175;863
2001;2002;3;Bayern München;34;68;40;65;25;20;8;6;68;48;München;48.1372∘N;11.5755∘O;1262;1851;1188;2706;1518;696;301;265;2389;1693
2001;2002;4;Hertha BSC Berlin;34;61;23;61;38;18;7;9;61;43;Berlin;52.5200∘N;13.4050∘O;706;781;-66;1052;1118;265;172;269;967;702
2001;2002;5;Schalke 04;34;61;16;52;36;18;7;9;61;43;Gelsenkirchen;51.5167∘N;7.0500∘O;1152;1230;-95;1677;1772;417;294;441;1545;1128
2001;2002;6;Werder Bremen;34;56;11;54;43;17;5;12;56;39;Bremen;53.0736∘N;8.8064∘O;1288;1525;287;2125;1838;542;328;418;1954;1412
2001;2002;7;1. FC Kaiserslautern;34;56;9;62;53;17;5;12;56;39;Kaiserslautern;49.4444∘N;7.7778∘O;1288;1463;95;2107;2012;517;323;448;1874;1357
2001;2002;8;VfB Stuttgart;34;50;4;47;43;13;11;10;50;37;Stuttgart;48.7833∘N;9.1833∘O;1254;1447;327;2172;1845;521;308;425;1871;1350
2001;2002;9;1860 München;34;50;0;59;59;15;5;14;50;35;München;48.1372∘N;11.5755∘O;604;684;-6;946;952;218;153;233;807;589
2001;2002;10;VfL Wolfsburg;34;46;8;57;49;13;7;14;46;33;Wolfsburg;52.4237∘N;10.7865∘O;170;236;5;260;255;63;47;60;236;173
2001;2002;11;Hamburger SV;34;40;-6;51;57;10;10;14;40;30;Hamburg;53.5511∘N;9.9937∘O;1322;1543;352;2240;1888;545;361;416;1996;1451
2001;2002;12;Bor. Mönchengladbach;34;39;-12;41;53;9;12;13;39;30;Mönchengladbach;51.1965∘N;6.4385∘O;1194;1399;453;2213;1760;506;321;367;1839;1333
2001;2002;13;Energie Cottbus;34;35;-24;36;60;9;8;17;35;26;Cottbus;51.7516∘N;14.3364∘O;68;74;-38;74;112;21;11;36;74;53
2001;2002;14;Hansa Rostock;34;34;-19;35;54;9;7;18;34;25;Rostock;54.0924∘N;12.1287∘O;276;324;-68;341;409;86;76;114;334;248
2001;2002;15;1. FC Nürnberg;34;34;-23;34;57;10;4;20;34;24;Nürnberg;49.4521∘N;11.0767∘O;744;691;-206;994;1200;244;186;314;918;674
2001;2002;16;SC Freiburg;34;30;-27;37;64;7;9;18;30;23;Freiburg im Breisgau;47.9990∘N;7.8421∘O;272;329;-39;365;404;91;66;115;339;248
2001;2002;17;1. FC Köln;34;29;-35;26;61;7;8;19;29;22;Köln;50.9333∘N;6.9500∘O;1254;1459;411;2224;1813;539;319;396;1936;1397
2001;2002;18;FC St. Pauli;34;22;-33;37;70;4;10;20;22;18;Hamburg;53.5511∘N;9.9937∘O;238;195;-156;261;417;50;75;113;225;175
2002;2003;1;Bayern München;34;75;45;70;25;23;6;5;75;52;München;48.1372∘N;11.5755∘O;1296;1926;1233;2776;1543;719;307;270;2464;1745
2002;2003;2;VfB Stuttgart;34;59;14;53;39;17;8;9;59;42;Stuttgart;48.7833∘N;9.1833∘O;1288;1506;341;2225;1884;538;316;434;1930;1392
2002;2003;3;Borussia Dortmund;34;58;24;51;27;15;13;6;58;43;Dortmund;51.5136∘N;7.4653∘O;1220;1477;288;2122;1834;507;317;396;1838;1331
2002;2003;4;Hamburger SV;34;56;10;46;36;15;11;8;56;41;Hamburg;53.5511∘N;9.9937∘O;1356;1599;362;2286;1924;560;372;424;2052;1492
2002;2003;5;Hertha BSC Berlin;34;54;9;52;43;16;6;12;54;38;Berlin;52.5200∘N;13.4050∘O;740;835;-57;1104;1161;281;178;281;1021;740
2002;2003;6;Werder Bremen;34;52;1;51;50;16;4;14;52;36;Bremen;53.0736∘N;8.8064∘O;1322;1577;288;2176;1888;558;332;432;2006;1448
2002;2003;7;Schalke 04;34;49;6;46;40;12;13;9;49;37;Gelsenkirchen;51.5167∘N;7.0500∘O;1186;1279;-89;1723;1812;429;307;450;1594;1165
2002;2003;8;VfL Wolfsburg;34;46;-3;39;42;13;7;14;46;33;Wolfsburg;52.4237∘N;10.7865∘O;204;282;2;299;297;76;54;74;282;206
2002;2003;9;VfL Bochum;34;45;-1;55;56;12;9;13;45;33;Bochum;51.4818∘N;7.2163∘O;956;901;-228;1329;1557;296;249;411;1137;841
2002;2003;10;1860 München;34;45;-8;44;52;12;9;13;45;33;München;48.1372∘N;11.5755∘O;638;729;-14;990;1004;230;162;246;852;622
2002;2003;11;Hannover 96;34;43;-10;47;57;12;7;15;43;31;Hannover;52.3759∘N;9.7320∘O;506;435;-162;730;892;148;127;231;571;423
2002;2003;12;Bor. Mönchengladbach;34;42;-2;43;45;11;9;14;42;31;Mönchengladbach;51.1965∘N;6.4385∘O;1228;1441;451;2256;1805;517;330;381;1881;1364
2002;2003;13;Hansa Rostock;34;41;-6;35;41;11;8;15;41;30;Rostock;54.0924∘N;12.1287∘O;310;365;-74;376;450;97;84;129;375;278
2002;2003;14;1. FC Kaiserslautern;34;40;-2;40;42;10;10;14;40;30;Kaiserslautern;49.4444∘N;7.7778∘O;1322;1503;93;2147;2054;527;333;462;1914;1387
2002;2003;15;Bayer Leverkusen;34;40;-9;47;56;11;7;16;40;29;Leverkusen;51.0416∘N;7.0004∘O;820;1035;188;1315;1127;323;246;251;1215;892
2002;2003;16;Arminia Bielefeld;34;36;-11;35;46;8;12;14;36;28;Bielefeld;52.0211∘N;8.5342∘O;408;342;-191;506;697;109;90;196;417;308
2002;2003;17;1. FC Nürnberg;34;30;-27;33;60;8;6;20;30;22;Nürnberg;49.4521∘N;11.0767∘O;778;721;-233;1027;1260;252;192;334;948;696
2002;2003;18;Energie Cottbus;34;30;-30;34;64;7;9;18;30;23;Cottbus;51.7516∘N;14.3364∘O;102;104;-68;108;176;28;20;54;104;76
2003;2004;1;Werder Bremen;34;74;41;79;38;22;8;4;74;52;Bremen;53.0736∘N;8.8064∘O;1356;1651;329;2255;1926;580;340;436;2080;1500
2003;2004;2;Bayern München;34;68;31;70;39;20;8;6;68;48;München;48.1372∘N;11.5755∘O;1330;1994;1264;2846;1582;739;315;276;2532;1793
2003;2004;3;Bayer Leverkusen;34;65;34;73;39;19;8;7;65;46;Leverkusen;51.0416∘N;7.0004∘O;854;1100;222;1388;1166;342;254;258;1280;938
2003;2004;4;VfB Stuttgart;34;64;28;52;24;18;10;6;64;46;Stuttgart;48.7833∘N;9.1833∘O;1322;1570;369;2277;1908;556;326;440;1994;1438
2003;2004;5;VfL Bochum;34;56;18;57;39;15;11;8;56;41;Bochum;51.4818∘N;7.2163∘O;990;957;-210;1386;1596;311;260;419;1193;882
2003;2004;6;Borussia Dortmund;34;55;11;59;48;16;7;11;55;39;Dortmund;51.5136∘N;7.4653∘O;1254;1532;299;2181;1882;523;324;407;1893;1370
2003;2004;7;Schalke 04;34;50;7;49;42;13;11;10;50;37;Gelsenkirchen;51.5167∘N;7.0500∘O;1220;1329;-82;1772;1854;442;318;460;1644;1202
2003;2004;8;Hamburger SV;34;49;-13;47;60;14;7;13;49;35;Hamburg;53.5511∘N;9.9937∘O;1390;1648;349;2333;1984;574;379;437;2101;1527
2003;2004;9;Hansa Rostock;34;44;1;55;54;12;8;14;44;32;Rostock;54.0924∘N;12.1287∘O;344;409;-73;431;504;109;92;143;419;310
2003;2004;10;VfL Wolfsburg;34;42;-5;56;61;13;3;18;42;29;Wolfsburg;52.4237∘N;10.7865∘O;238;324;-3;355;358;89;57;92;324;235
2003;2004;11;Bor. Mönchengladbach;34;39;-9;40;49;10;9;15;39;29;Mönchengladbach;51.1965∘N;6.4385∘O;1262;1480;442;2296;1854;527;339;396;1920;1393
2003;2004;12;Hertha BSC Berlin;34;39;-17;42;59;9;12;13;39;30;Berlin;52.5200∘N;13.4050∘O;774;874;-74;1146;1220;290;190;294;1060;770
2003;2004;13;SC Freiburg;34;38;-25;42;67;10;8;16;38;28;Freiburg im Breisgau;47.9990∘N;7.8421∘O;306;367;-64;407;471;101;74;131;377;276
2003;2004;14;Hannover 96;34;37;-14;49;63;9;10;15;37;28;Hannover;52.3759∘N;9.7320∘O;540;472;-176;779;955;157;137;246;608;451
2003;2004;15;1. FC Kaiserslautern;34;36;-23;39;62;11;6;17;39;28;Kaiserslautern;49.4444∘N;7.7778∘O;1356;1539;70;2186;2116;538;339;479;1953;1415
2003;2004;16;Eintracht Frankfurt;34;32;-17;36;53;9;5;20;32;23;Frankfurt am Main;50.1109∘N;8.6821∘O;1254;1325;134;2079;1945;479;310;465;1747;1268
2003;2004;17;1860 München;34;32;-23;32;55;8;8;18;32;24;München;48.1372∘N;11.5755∘O;672;761;-37;1022;1059;238;170;264;884;646
2003;2004;18;1. FC Köln;34;23;-25;32;57;6;5;23;23;17;Köln;50.9333∘N;6.9500∘O;1288;1482;386;2256;1870;545;324;419;1959;1414
2004;2005;1;Bayern München;34;77;42;75;33;24;5;5;77;53;München;48.1372∘N;11.5755∘O;1364;2071;1306;2921;1615;763;320;281;2609;1846
2004;2005;2;Schalke 04;34;63;10;56;46;20;3;11;63;43;Gelsenkirchen;51.5167∘N;7.0500∘O;1254;1392;-72;1828;1900;462;321;471;1707;1245
2004;2005;3;Werder Bremen;34;59;31;68;37;18;5;11;59;41;Bremen;53.0736∘N;8.8064∘O;1390;1710;360;2323;1963;598;345;447;2139;1541
2004;2005;4;Hertha BSC Berlin;34;58;28;59;31;15;13;6;58;43;Berlin;52.5200∘N;13.4050∘O;808;932;-46;1205;1251;305;203;300;1118;813
2004;2005;5;VfB Stuttgart;34;58;14;54;40;17;7;10;58;41;Stuttgart;48.7833∘N;9.1833∘O;1356;1628;383;2331;1948;573;333;450;2052;1479
2004;2005;6;Bayer Leverkusen;34;57;21;65;44;16;9;9;57;41;Leverkusen;51.0416∘N;7.0004∘O;888;1157;243;1453;1210;358;263;267;1337;979
2004;2005;7;Borussia Dortmund;34;55;3;47;44;15;10;9;55;40;Dortmund;51.5136∘N;7.4653∘O;1288;1587;302;2228;1926;538;334;416;1948;1410
2004;2005;8;Hamburger SV;34;51;5;55;50;16;3;15;51;35;Hamburg;53.5511∘N;9.9937∘O;1424;1699;354;2388;2034;590;382;452;2152;1562
2004;2005;9;VfL Wolfsburg;34;48;-2;49;51;15;3;16;48;33;Wolfsburg;52.4237∘N;10.7865∘O;272;372;-5;404;409;104;60;108;372;268
2004;2005;10;Hannover 96;34;45;-2;34;36;13;6;15;45;32;Hannover;52.3759∘N;9.7320∘O;574;517;-178;813;991;170;143;261;653;483
2004;2005;11;1. FSV Mainz 05;34;43;-5;50;55;12;7;15;43;31;Mainz;50.0000∘N;8.2711∘O;34;43;-5;50;55;12;7;15;43;31
2004;2005;12;1. FC Kaiserslautern;34;42;-9;43;52;12;6;16;42;30;Kaiserslautern;49.4444∘N;7.7778∘O;1390;1581;61;2229;2168;550;345;495;1995;1445
2004;2005;13;Arminia Bielefeld;34;40;-12;37;49;11;7;16;40;29;Bielefeld;52.0211∘N;8.5342∘O;442;382;-203;543;746;120;97;212;457;337
2004;2005;14;1. FC Nürnberg;34;38;-8;55;63;10;8;16;38;28;Nürnberg;49.4521∘N;11.0767∘O;812;759;-241;1082;1323;262;200;350;986;724
2004;2005;15;Bor. Mönchengladbach;34;36;-16;35;51;8;12;14;36;28;Mönchengladbach;51.1965∘N;6.4385∘O;1296;1516;426;2331;1905;535;351;410;1956;1421
2004;2005;16;VfL Bochum;34;35;-21;47;68;9;8;17;35;26;Bochum;51.4818∘N;7.2163∘O;1024;992;-231;1433;1664;320;268;436;1228;908
2004;2005;17;Hansa Rostock;34;30;-34;31;65;7;9;18;30;23;Rostock;54.0924∘N;12.1287∘O;378;439;-107;462;569;116;101;161;449;333
2004;2005;18;SC Freiburg;34;18;-45;30;75;3;9;22;18;15;Freiburg im Breisgau;47.9990∘N;7.8421∘O;340;385;-109;437;546;104;83;153;395;291
2005;2006;1;Bayern München;34;75;35;67;32;22;9;3;75;53;München;48.1372∘N;11.5755∘O;1398;2146;1341;2988;1647;785;329;284;2684;1899
2005;2006;2;Werder Bremen;34;70;42;79;37;21;7;6;70;49;Bremen;53.0736∘N;8.8064∘O;1424;1780;402;2402;2000;619;352;453;2209;1590
2005;2006;3;Hamburger SV;34;68;23;53;30;21;5;8;68;47;Hamburg;53.5511∘N;9.9937∘O;1458;1767;377;2441;2064;611;387;460;2220;1609
2005;2006;4;Schalke 04;34;61;16;47;31;16;13;5;61;45;Gelsenkirchen;51.5167∘N;7.0500∘O;1288;1453;-56;1875;1931;478;334;476;1768;1290
2005;2006;5;Bayer Leverkusen;34;52;15;64;49;14;10;10;52;38;Leverkusen;51.0416∘N;7.0004∘O;922;1209;258;1517;1259;372;273;277;1389;1017
2005;2006;6;Hertha BSC Berlin;34;48;4;52;48;12;12;10;48;36;Berlin;52.5200∘N;13.4050∘O;842;980;-42;1257;1299;317;215;310;1166;849
2005;2006;7;Borussia Dortmund;34;46;3;45;42;11;13;10;46;35;Dortmund;51.5136∘N;7.4653∘O;1322;1633;305;2273;1968;549;347;426;1994;1445
2005;2006;8;1. FC Nürnberg;34;44;-2;49;51;12;8;14;44;32;Nürnberg;49.4521∘N;11.0767∘O;846;803;-243;1131;1374;274;208;364;1030;756
2005;2006;9;VfB Stuttgart;34;43;-2;37;39;9;16;9;43;34;Stuttgart;48.7833∘N;9.1833∘O;1390;1671;381;2368;1987;582;349;459;2095;1513
2005;2006;10;Bor. Mönchengladbach;34;42;-8;42;50;10;12;12;42;32;Mönchengladbach;51.1965∘N;6.4385∘O;1330;1558;418;2373;1955;545;363;422;1998;1453
2005;2006;11;1. FSV Mainz 05;34;38;-1;46;47;9;11;14;38;29;Mainz;50.0000∘N;8.2711∘O;68;81;-6;96;102;21;18;29;81;60
2005;2006;12;Hannover 96;34;38;-4;43;47;7;17;10;38;31;Hannover;52.3759∘N;9.7320∘O;608;555;-182;856;1038;177;160;271;691;514
2005;2006;13;Arminia Bielefeld;34;37;-15;32;47;10;7;17;37;27;Bielefeld;52.0211∘N;8.5342∘O;476;419;-218;575;793;130;104;229;494;364
2005;2006;14;Eintracht Frankfurt;34;36;-9;42;51;9;9;16;36;27;Frankfurt am Main;50.1109∘N;8.6821∘O;1288;1361;125;2121;1996;488;319;481;1783;1295
2005;2006;15;VfL Wolfsburg;34;34;-22;33;55;7;13;14;34;27;Wolfsburg;52.4237∘N;10.7865∘O;306;406;-27;437;464;111;73;122;406;295
2005;2006;16;1. FC Kaiserslautern;34;33;-24;47;71;8;9;17;33;25;Kaiserslautern;49.4444∘N;7.7778∘O;1424;1614;37;2276;2239;558;354;512;2028;1470
2005;2006;17;1. FC Köln;34;30;-22;49;71;7;9;18;30;23;Köln;50.9333∘N;6.9500∘O;1322;1512;364;2305;1941;552;333;437;1989;1437
2005;2006;18;MSV Duisburg;34;27;-29;34;63;5;12;17;27;22;Duisburg;51.4333∘N;6.7667∘O;880;859;-176;1218;1394;284;244;352;1096;812
2006;2007;1;VfB Stuttgart;34;70;24;61;37;21;7;6;70;49;Stuttgart;48.7833∘N;9.1833∘O;1424;1741;405;2429;2024;603;356;465;2165;1562
2006;2007;2;Schalke 04;34;68;21;53;32;21;5;8;68;47;Gelsenkirchen;51.5167∘N;7.0500∘O;1322;1521;-35;1928;1963;499;339;484;1836;1337
2006;2007;3;Werder Bremen;34;66;36;76;40;20;6;8;66;46;Bremen;53.0736∘N;8.8064∘O;1458;1846;438;2478;2040;639;358;461;2275;1636
2006;2007;4;Bayern München;34;60;15;55;40;18;6;10;60;42;München;48.1372∘N;11.5755∘O;1432;2206;1356;3043;1687;803;335;294;2744;1941
2006;2007;5;Bayer Leverkusen;34;51;5;54;49;15;6;13;51;36;Leverkusen;51.0416∘N;7.0004∘O;956;1260;263;1571;1308;387;279;290;1440;1053
2006;2007;6;1. FC Nürnberg;34;48;11;43;32;11;15;8;48;37;Nürnberg;49.4521∘N;11.0767∘O;880;851;-232;1174;1406;285;223;372;1078;793
2006;2007;7;Hamburger SV;34;45;6;43;37;10;15;9;45;35;Hamburg;53.5511∘N;9.9937∘O;1492;1812;383;2484;2101;621;402;469;2265;1644
2006;2007;8;VfL Bochum;34;45;-1;49;50;13;6;15;45;32;Bochum;51.4818∘N;7.2163∘O;1058;1037;-232;1482;1714;333;274;451;1273;940
2006;2007;9;Borussia Dortmund;34;44;-2;41;43;12;8;14;44;32;Dortmund;51.5136∘N;7.4653∘O;1356;1677;303;2314;2011;561;355;440;2038;1477
2006;2007;10;Hertha BSC Berlin;34;44;-5;50;55;12;8;14;44;32;Berlin;52.5200∘N;13.4050∘O;876;1024;-47;1307;1354;329;223;324;1210;881
2006;2007;11;Hannover 96;34;44;-9;41;50;12;8;14;44;32;Hannover;52.3759∘N;9.7320∘O;642;599;-191;897;1088;189;168;285;735;546
2006;2007;12;Arminia Bielefeld;34;42;-2;47;49;11;9;14;42;31;Bielefeld;52.0211∘N;8.5342∘O;510;461;-220;622;842;141;113;243;536;395
2006;2007;13;Energie Cottbus;34;41;-11;38;49;11;8;15;41;30;Cottbus;51.7516∘N;14.3364∘O;136;145;-79;146;225;39;28;69;145;106
2006;2007;14;Eintracht Frankfurt;34;40;-12;46;58;9;13;12;40;31;Frankfurt am Main;50.1109∘N;8.6821∘O;1322;1401;113;2167;2054;497;332;493;1823;1326
2006;2007;15;VfL Wolfsburg;34;37;-8;37;45;8;13;13;37;29;Wolfsburg;52.4237∘N;10.7865∘O;340;443;-35;474;509;119;86;135;443;324
2006;2007;16;1. FSV Mainz 05;34;34;-23;34;57;8;10;16;34;26;Mainz;50.0000∘N;8.2711∘O;102;115;-29;130;159;29;28;45;115;86
2006;2007;17;Alemannia Aachen;34;34;-24;46;70;9;7;18;34;25;Aachen;50.7753∘N;6.0839∘O;136;123;-84;186;270;43;28;65;157;114
2006;2007;18;Bor. Mönchengladbach;34;26;-21;23;44;6;8;20;26;20;Mönchengladbach;51.1965∘N;6.4385∘O;1364;1584;397;2396;1999;551;371;442;2024;1473
2007;2008;1;Bayern München;34;76;47;68;21;22;10;2;76;54;München;48.1372∘N;11.5755∘O;1466;2282;1403;3111;1708;825;345;296;2820;1995
2007;2008;2;Werder Bremen;34;66;30;75;45;20;6;8;66;46;Bremen;53.0736∘N;8.8064∘O;1492;1912;468;2553;2085;659;364;469;2341;1682
2007;2008;3;Schalke 04;34;64;23;55;32;18;10;6;64;46;Gelsenkirchen;51.5167∘N;7.0500∘O;1356;1585;-12;1983;1995;517;349;490;1900;1383
2007;2008;4;Hamburger SV;34;54;21;47;26;14;12;8;54;40;Hamburg;53.5511∘N;9.9937∘O;1526;1866;404;2531;2127;635;414;477;2319;1684
2007;2008;5;VfL Wolfsburg;34;54;12;58;46;15;9;10;54;39;Wolfsburg;52.4237∘N;10.7865∘O;374;497;-23;532;555;134;95;145;497;363
2007;2008;6;VfB Stuttgart;34;52;0;57;57;16;4;14;52;36;Stuttgart;48.7833∘N;9.1833∘O;1458;1793;405;2486;2081;619;360;479;2217;1598
2007;2008;7;Bayer Leverkusen;34;51;17;57;40;15;6;13;51;36;Leverkusen;51.0416∘N;7.0004∘O;990;1311;280;1628;1348;402;285;303;1491;1089
2007;2008;8;Hannover 96;34;49;-2;54;56;13;10;11;49;36;Hannover;52.3759∘N;9.7320∘O;676;648;-193;951;1144;202;178;296;784;582
2007;2008;9;Eintracht Frankfurt;34;46;-7;43;50;12;10;12;46;34;Frankfurt am Main;50.1109∘N;8.6821∘O;1356;1447;106;2210;2104;509;342;505;1869;1360
2007;2008;10;Hertha BSC Berlin;34;44;-5;39;44;12;8;14;44;32;Berlin;52.5200∘N;13.4050∘O;910;1068;-52;1346;1398;341;231;338;1254;913
2007;2008;11;Karlsruher SC;34;43;-15;38;53;11;10;13;43;32;Karlsruhe;49.0069∘N;8.4037∘O;778;747;-291;1063;1354;233;225;320;924;691
2007;2008;12;VfL Bochum;34;41;-6;48;54;10;11;13;41;31;Bochum;51.4818∘N;7.2163∘O;1092;1078;-238;1530;1768;343;285;464;1314;971
2007;2008;13;Borussia Dortmund;34;40;-12;50;62;10;10;14;40;30;Dortmund;51.5136∘N;7.4653∘O;1390;1717;291;2364;2073;571;365;454;2078;1507
2007;2008;14;Energie Cottbus;34;36;-21;35;56;9;9;16;36;27;Cottbus;51.7516∘N;14.3364∘O;170;181;-100;181;281;48;37;85;181;133
2007;2008;15;Arminia Bielefeld;34;34;-25;35;60;8;10;16;34;26;Bielefeld;52.0211∘N;8.5342∘O;544;495;-245;657;902;149;123;259;570;421
2007;2008;16;1. FC Nürnberg;34;31;-16;35;51;7;10;17;31;24;Nürnberg;49.4521∘N;11.0767∘O;914;882;-248;1209;1457;292;233;389;1109;817
2007;2008;17;Hansa Rostock;34;30;-22;30;52;8;6;20;30;22;Rostock;54.0924∘N;12.1287∘O;412;469;-129;492;621;124;107;181;479;355
2007;2008;18;MSV Duisburg;34;29;-19;36;55;8;5;21;29;21;Duisburg;51.4333∘N;6.7667∘O;914;888;-195;1254;1449;292;249;373;1125;833
2008;2009;1;VfL Wolfsburg;34;69;39;80;41;21;6;7;69;48;Wolfsburg;52.4237∘N;10.7865∘O;408;566;16;612;596;155;101;152;566;411
2008;2009;2;Bayern München;34;67;29;71;42;20;7;7;67;47;München;48.1372∘N;11.5755∘O;1500;2349;1432;3182;1750;845;352;303;2887;2042
2008;2009;3;VfB Stuttgart;34;64;20;63;43;19;7;8;64;45;Stuttgart;48.7833∘N;9.1833∘O;1492;1857;425;2549;2124;638;367;487;2281;1643
2008;2009;4;Hertha BSC Berlin;34;63;7;48;41;19;6;9;63;44;Berlin;52.5200∘N;13.4050∘O;944;1131;-45;1394;1439;360;237;347;1317;957
2008;2009;5;Hamburger SV;34;61;2;49;47;19;4;11;61;42;Hamburg;53.5511∘N;9.9937∘O;1560;1927;406;2580;2174;654;418;488;2380;1726
2008;2009;6;Borussia Dortmund;34;59;23;60;37;15;14;5;59;44;Dortmund;51.5136∘N;7.4653∘O;1424;1776;314;2424;2110;586;379;459;2137;1551
2008;2009;7;TSG Hoffenheim;34;55;14;63;49;15;10;9;55;40;Sinsheim;49.2500∘N;8.8833∘O;34;55;14;63;49;15;10;9;55;40
2008;2009;8;Schalke 04;34;50;12;47;35;14;8;12;50;36;Gelsenkirchen;51.5167∘N;7.0500∘O;1390;1635;0;2030;2030;531;357;502;1950;1419
2008;2009;9;Bayer Leverkusen;34;49;13;59;46;14;7;13;49;35;Leverkusen;51.0416∘N;7.0004∘O;1024;1360;293;1687;1394;416;292;316;1540;1124
2008;2009;10;Werder Bremen;34;45;14;64;50;12;9;13;45;33;Bremen;53.0736∘N;8.8064∘O;1526;1957;482;2617;2135;671;373;482;2386;1715
2008;2009;11;Hannover 96;34;40;-20;49;69;10;10;14;40;30;Hannover;52.3759∘N;9.7320∘O;710;688;-213;1000;1213;212;188;310;824;612
2008;2009;12;1. FC Köln;34;39;-15;35;50;11;6;17;39;28;Köln;50.9333∘N;6.9500∘O;1356;1551;349;2340;1991;563;339;454;2028;1465
2008;2009;13;Eintracht Frankfurt;34;33;-21;39;60;8;9;17;33;25;Frankfurt am Main;50.1109∘N;8.6821∘O;1390;1480;85;2249;2164;517;351;522;1902;1385
2008;2009;14;VfL Bochum;34;32;-16;39;55;7;11;16;32;25;Bochum;51.4818∘N;7.2163∘O;1126;1110;-254;1569;1823;350;296;480;1346;996
2008;2009;15;Bor. Mönchengladbach;34;31;-23;39;62;8;7;19;31;23;Mönchengladbach;51.1965∘N;6.4385∘O;1398;1615;374;2435;2061;559;378;461;2055;1496
2008;2009;16;Energie Cottbus;34;30;-27;30;57;8;6;20;30;22;Cottbus;51.7516∘N;14.3364∘O;204;211;-127;211;338;56;43;105;211;155
2008;2009;17;Karlsruher SC;34;29;-24;30;54;8;5;21;29;21;Karlsruhe;49.0069∘N;8.4037∘O;812;776;-315;1093;1408;241;230;341;953;712
2008;2009;18;Arminia Bielefeld;34;28;-27;29;56;4;16;14;28;24;Bielefeld;52.0211∘N;8.5342∘O;578;523;-272;686;958;153;139;273;598;445
2009;2010;1;Bayern München;34;70;41;72;31;20;10;4;70;50;München;48.1372∘N;11.5755∘O;1534;2419;1473;3254;1781;865;362;307;2957;2092
2009;2010;2;Schalke 04;34;65;22;53;31;19;8;7;65;46;Gelsenkirchen;51.5167∘N;7.0500∘O;1424;1700;22;2083;2061;550;365;509;2015;1465
2009;2010;3;Werder Bremen;34;61;31;71;40;17;10;7;61;44;Bremen;53.0736∘N;8.8064∘O;1560;2018;513;2688;2175;688;383;489;2447;1759
2009;2010;4;Bayer Leverkusen;34;59;27;65;38;15;14;5;59;44;Leverkusen;51.0416∘N;7.0004∘O;1058;1419;320;1752;1432;431;306;321;1599;1168
2009;2010;5;Borussia Dortmund;34;57;12;54;42;16;9;9;57;41;Dortmund;51.5136∘N;7.4653∘O;1458;1833;326;2478;2152;602;388;468;2194;1592
2009;2010;6;VfB Stuttgart;34;55;10;51;41;15;10;9;55;40;Stuttgart;48.7833∘N;9.1833∘O;1526;1912;435;2600;2165;653;377;496;2336;1683
2009;2010;7;Hamburger SV;34;52;15;56;41;13;13;8;52;39;Hamburg;53.5511∘N;9.9937∘O;1594;1979;421;2636;2215;667;431;496;2432;1765
2009;2010;8;VfL Wolfsburg;34;50;6;64;58;14;8;12;50;36;Wolfsburg;52.4237∘N;10.7865∘O;442;616;22;676;654;169;109;164;616;447
2009;2010;9;1. FSV Mainz 05;34;47;-6;36;42;12;11;11;47;35;Mainz;50.0000∘N;8.2711∘O;136;162;-35;166;201;41;39;56;162;121
2009;2010;10;Eintracht Frankfurt;34;46;-7;47;54;12;10;12;46;34;Frankfurt am Main;50.1109∘N;8.6821∘O;1424;1526;78;2296;2218;529;361;534;1948;1419
2009;2010;11;TSG Hoffenheim;34;42;2;44;42;11;9;14;42;31;Sinsheim;49.2500∘N;8.8833∘O;68;97;16;107;91;26;19;23;97;71
2009;2010;12;Bor. Mönchengladbach;34;39;-17;43;60;10;9;15;39;29;Mönchengladbach;51.1965∘N;6.4385∘O;1432;1654;357;2478;2121;569;387;476;2094;1525
2009;2010;13;1. FC Köln;34;38;-9;33;42;9;11;14;38;29;Köln;50.9333∘N;6.9500∘O;1390;1589;340;2373;2033;572;350;468;2066;1494
2009;2010;14;SC Freiburg;34;35;-24;35;59;9;8;17;35;26;Freiburg im Breisgau;47.9990∘N;7.8421∘O;374;420;-133;472;605;113;91;170;430;317
2009;2010;15;Hannover 96;34;33;-24;43;67;9;6;19;33;24;Hannover;52.3759∘N;9.7320∘O;744;721;-237;1043;1280;221;194;329;857;636
2009;2010;16;1. FC Nürnberg;34;31;-26;32;58;8;7;19;31;23;Nürnberg;49.4521∘N;11.0767∘O;948;913;-274;1241;1515;300;240;408;1140;840
2009;2010;17;VfL Bochum;34;28;-31;33;64;6;10;18;28;22;Bochum;51.4818∘N;7.2163∘O;1160;1138;-285;1602;1887;356;306;498;1374;1018
2009;2010;18;Hertha BSC Berlin;34;24;-22;34;56;5;9;20;24;19;Berlin;52.5200∘N;13.4050∘O;978;1155;-67;1428;1495;365;246;367;1341;976
2010;2011;1;Borussia Dortmund;34;75;45;67;22;23;6;5;75;52;Dortmund;51.5136∘N;7.4653∘O;1492;1908;371;2545;2174;625;394;473;2269;1644
2010;2011;2;Bayer Leverkusen;34;68;20;64;44;20;8;6;68;48;Leverkusen;51.0416∘N;7.0004∘O;1092;1487;340;1816;1476;451;314;327;1667;1216
2010;2011;3;Bayern München;34;65;41;81;40;19;8;7;65;46;München;48.1372∘N;11.5755∘O;1568;2484;1514;3335;1821;884;370;314;3022;2138
2010;2011;4;Hannover 96;34;60;4;49;45;19;3;12;60;41;Hannover;52.3759∘N;9.7320∘O;778;781;-233;1092;1325;240;197;341;917;677
2010;2011;5;1. FSV Mainz 05;34;58;13;52;39;18;4;12;58;40;Mainz;50.0000∘N;8.2711∘O;170;220;-22;218;240;59;43;68;220;161
2010;2011;6;1. FC Nürnberg;34;47;2;47;45;13;8;13;47;34;Nürnberg;49.4521∘N;11.0767∘O;982;960;-272;1288;1560;313;248;421;1187;874
2010;2011;7;1. FC Kaiserslautern;34;46;-3;48;51;13;7;14;46;33;Kaiserslautern;49.4444∘N;7.7778∘O;1458;1660;34;2324;2290;571;361;526;2074;1503
2010;2011;8;Hamburger SV;34;45;-6;46;52;12;9;13;45;33;Hamburg;53.5511∘N;9.9937∘O;1628;2024;415;2682;2267;679;440;509;2477;1798
2010;2011;9;SC Freiburg;34;44;-9;41;50;13;5;16;44;31;Freiburg im Breisgau;47.9990∘N;7.8421∘O;408;464;-142;513;655;126;96;186;474;348
2010;2011;10;1. FC Köln;34;44;-15;47;62;13;5;16;44;31;Köln;50.9333∘N;6.9500∘O;1424;1633;325;2420;2095;585;355;484;2110;1525
2010;2011;11;TSG Hoffenheim;34;43;0;50;50;11;10;13;43;32;Sinsheim;49.2500∘N;8.8833∘O;102;140;16;157;141;37;29;36;140;103
2010;2011;12;VfB Stuttgart;34;42;1;60;59;12;6;16;42;30;Stuttgart;48.7833∘N;9.1833∘O;1560;1954;436;2660;2224;665;383;512;2378;1713
2010;2011;13;Werder Bremen;34;41;-14;47;61;10;11;13;41;31;Bremen;53.0736∘N;8.8064∘O;1594;2059;499;2735;2236;698;394;502;2488;1790
2010;2011;14;Schalke 04;34;40;-6;38;44;11;7;16;40;29;Gelsenkirchen;51.5167∘N;7.0500∘O;1458;1740;16;2121;2105;561;372;525;2055;1494
2010;2011;15;VfL Wolfsburg;34;38;-5;43;48;9;11;14;38;29;Wolfsburg;52.4237∘N;10.7865∘O;476;654;17;719;702;178;120;178;654;476
2010;2011;16;Bor. Mönchengladbach;34;36;-17;48;65;10;6;18;36;26;Mönchengladbach;51.1965∘N;6.4385∘O;1466;1690;340;2526;2186;579;393;494;2130;1551
2010;2011;17;Eintracht Frankfurt;34;34;-18;31;49;9;7;18;34;25;Frankfurt am Main;50.1109∘N;8.6821∘O;1458;1560;60;2327;2267;538;368;552;1982;1444
2010;2011;18;FC St. Pauli;34;29;-33;35;68;8;5;21;29;21;Hamburg;53.5511∘N;9.9937∘O;272;224;-189;296;485;58;80;134;254;196
2011;2012;1;Borussia Dortmund;34;81;55;80;25;25;6;3;81;56;Dortmund;51.5136∘N;7.4653∘O;1526;1989;426;2625;2199;650;400;476;2350;1700
2011;2012;2;Bayern München;34;73;55;77;22;23;4;7;73;50;München;48.1372∘N;11.5755∘O;1602;2557;1569;3412;1843;907;374;321;3095;2188
2011;2012;3;Schalke 04;34;64;30;74;44;20;4;10;64;44;Gelsenkirchen;51.5167∘N;7.0500∘O;1492;1804;46;2195;2149;581;376;535;2119;1538
2011;2012;4;Bor. Mönchengladbach;34;60;25;49;24;17;9;8;60;43;Mönchengladbach;51.1965∘N;6.4385∘O;1500;1750;365;2575;2210;596;402;502;2190;1594
2011;2012;5;Bayer Leverkusen;34;54;8;52;44;15;9;10;54;39;Leverkusen;51.0416∘N;7.0004∘O;1126;1541;348;1868;1520;466;323;337;1721;1255
2011;2012;6;VfB Stuttgart;34;53;17;63;46;15;8;11;53;38;Stuttgart;48.7833∘N;9.1833∘O;1594;2007;453;2723;2270;680;391;523;2431;1751
2011;2012;7;Hannover 96;34;48;-4;41;45;12;12;10;48;36;Hannover;52.3759∘N;9.7320∘O;812;829;-237;1133;1370;252;209;351;965;713
2011;2012;8;VfL Wolfsburg;34;44;-13;47;60;13;5;16;44;31;Wolfsburg;52.4237∘N;10.7865∘O;510;698;4;766;762;191;125;194;698;507
2011;2012;9;Werder Bremen;34;42;-9;49;58;11;9;14;42;31;Bremen;53.0736∘N;8.8064∘O;1628;2101;490;2784;2294;709;403;516;2530;1821
2011;2012;10;1. FC Nürnberg;34;42;-11;38;49;12;6;16;42;30;Nürnberg;49.4521∘N;11.0767∘O;1016;1002;-283;1326;1609;325;254;437;1229;904
2011;2012;11;TSG Hoffenheim;34;41;-6;41;47;10;11;13;41;31;Sinsheim;49.2500∘N;8.8833∘O;136;181;10;198;188;47;40;49;181;134
2011;2012;12;SC Freiburg;34;40;-16;45;61;10;10;14;40;30;Freiburg im Breisgau;47.9990∘N;7.8421∘O;442;504;-158;558;716;136;106;200;514;378
2011;2012;13;1. FSV Mainz 05;34;39;-4;47;51;9;12;13;39;30;Mainz;50.0000∘N;8.2711∘O;204;259;-26;265;291;68;55;81;259;191
2011;2012;14;FC Augsburg;34;38;-13;36;49;8;14;12;38;30;Augsburg;48.3705∘N;10.8977∘O;34;38;-13;36;49;8;14;12;38;30
2011;2012;15;Hamburger SV;34;36;-22;35;57;8;12;14;36;28;Hamburg;53.5511∘N;9.9937∘O;1662;2060;393;2717;2324;687;452;523;2513;1826
2011;2012;16;Hertha BSC Berlin;34;31;-26;38;64;7;10;17;31;24;Berlin;52.5200∘N;13.4050∘O;1012;1186;-93;1466;1559;372;256;384;1372;1000
2011;2012;17;1. FC Köln;34;30;-36;39;75;8;6;20;30;22;Köln;50.9333∘N;6.9500∘O;1458;1663;289;2459;2170;593;361;504;2140;1547
2011;2012;18;1. FC Kaiserslautern;34;23;-30;24;54;4;11;19;23;19;Kaiserslautern;49.4444∘N;7.7778∘O;1492;1683;4;2348;2344;575;372;545;2097;1522
2012;2013;1;Bayern München;34;91;80;98;18;29;4;1;91;62;München;48.1372∘N;11.5755∘O;1636;2648;1649;3510;1861;936;378;322;3186;2250
2012;2013;2;Borussia Dortmund;34;66;39;81;42;19;9;6;66;47;Dortmund;51.5136∘N;7.4653∘O;1560;2055;465;2706;2241;669;409;482;2416;1747
2012;2013;3;Bayer Leverkusen;34;65;26;65;39;19;8;7;65;46;Leverkusen;51.0416∘N;7.0004∘O;1160;1606;374;1933;1559;485;331;344;1786;1301
2012;2013;4;Schalke 04;34;55;8;58;50;16;7;11;55;39;Gelsenkirchen;51.5167∘N;7.0500∘O;1526;1859;54;2253;2199;597;383;546;2174;1577
2012;2013;5;SC Freiburg;34;51;5;45;40;14;9;11;51;37;Freiburg im Breisgau;47.9990∘N;7.8421∘O;476;555;-153;603;756;150;115;211;565;415
2012;2013;6;Eintracht Frankfurt;34;51;3;49;46;14;9;11;51;37;Frankfurt am Main;50.1109∘N;8.6821∘O;1492;1611;63;2376;2313;552;377;563;2033;1481
2012;2013;7;Hamburger SV;34;48;-11;42;53;14;6;14;48;34;Hamburg;53.5511∘N;9.9937∘O;1696;2108;382;2759;2377;701;458;537;2561;1860
2012;2013;8;Bor. Mönchengladbach;34;47;-4;45;49;12;11;11;47;35;Mönchengladbach;51.1965∘N;6.4385∘O;1534;1797;361;2620;2259;608;413;513;2237;1629
2012;2013;9;Hannover 96;34;45;-2;60;62;13;6;15;45;32;Hannover;52.3759∘N;9.7320∘O;846;874;-239;1193;1432;265;215;366;1010;745
2012;2013;10;1. FC Nürnberg;34;44;-8;39;47;11;11;12;44;33;Nürnberg;49.4521∘N;11.0767∘O;1050;1046;-291;1365;1656;336;265;449;1273;937
2012;2013;11;VfL Wolfsburg;34;43;-5;47;52;10;13;11;43;33;Wolfsburg;52.4237∘N;10.7865∘O;544;741;-1;813;814;201;138;205;741;540
2012;2013;12;VfB Stuttgart;34;43;-18;37;55;12;7;15;43;31;Stuttgart;48.7833∘N;9.1833∘O;1628;2050;435;2760;2325;692;398;538;2474;1782
2012;2013;13;1. FSV Mainz 05;34;42;-2;42;44;10;12;12;42;32;Mainz;50.0000∘N;8.2711∘O;238;301;-28;307;335;78;67;93;301;223
2012;2013;14;Werder Bremen;34;34;-16;50;66;8;10;16;34;26;Bremen;53.0736∘N;8.8064∘O;1662;2135;474;2834;2360;717;413;532;2564;1847
2012;2013;15;FC Augsburg;34;33;-18;33;51;8;9;17;33;25;Augsburg;48.3705∘N;10.8977∘O;68;71;-31;69;100;16;23;29;71;55
2012;2013;16;TSG Hoffenheim;34;31;-25;42;67;8;7;19;31;23;Sinsheim;49.2500∘N;8.8833∘O;170;212;-15;240;255;55;47;68;212;157
2012;2013;17;Fortuna Düsseldorf;34;30;-18;39;57;7;9;18;30;23;Düsseldorf;51.2217∘N;6.7761∘O;786;729;-226;1160;1386;245;215;326;950;705
2012;2013;18;Spvgg Greuther Fürth;34;21;-34;26;60;4;9;21;21;17;Fürth;49.4776∘N;10.9854∘O;34;21;-34;26;60;4;9;21;21;17
2013;2014;1;Bayern München;34;90;71;94;23;29;3;2;90;61;München;48.1372∘N;11.5755∘O;1670;2738;1720;3604;1884;965;381;324;3276;2311
2013;2014;2;Borussia Dortmund;34;71;42;80;38;22;5;7;71;49;Dortmund;51.5136∘N;7.4653∘O;1594;2126;507;2786;2279;691;414;489;2487;1796
2013;2014;3;Schalke 04;34;64;20;63;43;19;7;8;64;45;Gelsenkirchen;51.5167∘N;7.0500∘O;1560;1923;74;2316;2242;616;390;554;2238;1622
2013;2014;4;Bayer Leverkusen;34;61;19;60;41;19;4;11;61;42;Leverkusen;51.0416∘N;7.0004∘O;1194;1667;393;1993;1600;504;335;355;1847;1343
2013;2014;5;VfL Wolfsburg;34;60;13;63;50;18;6;10;60;42;Wolfsburg;52.4237∘N;10.7865∘O;578;801;12;876;864;219;144;215;801;582
2013;2014;6;Bor. Mönchengladbach;34;55;16;59;43;16;7;11;55;39;Mönchengladbach;51.1965∘N;6.4385∘O;1568;1852;377;2679;2302;624;420;524;2292;1668
2013;2014;7;1. FSV Mainz 05;34;53;-2;52;54;16;5;13;53;37;Mainz;50.0000∘N;8.2711∘O;272;354;-30;359;389;94;72;106;354;260
2013;2014;8;FC Augsburg;34;52;0;47;47;15;7;12;52;37;Augsburg;48.3705∘N;10.8977∘O;102;123;-31;116;147;31;30;41;123;92
2013;2014;9;TSG Hoffenheim;34;44;2;72;70;11;11;12;44;33;Sinsheim;49.2500∘N;8.8833∘O;204;256;-13;312;325;66;58;80;256;190
2013;2014;10;Hannover 96;34;42;-13;46;59;12;6;16;42;30;Hannover;52.3759∘N;9.7320∘O;880;916;-252;1239;1491;277;221;382;1052;775
2013;2014;11;Hertha BSC Berlin;34;41;-8;40;48;11;8;15;41;30;Berlin;52.5200∘N;13.4050∘O;1046;1227;-101;1506;1607;383;264;399;1413;1030
2013;2014;12;Werder Bremen;34;39;-24;42;66;10;9;15;39;29;Bremen;53.0736∘N;8.8064∘O;1696;2174;450;2876;2426;727;422;547;2603;1876
2013;2014;13;Eintracht Frankfurt;34;36;-17;40;57;9;9;16;36;27;Frankfurt am Main;50.1109∘N;8.6821∘O;1526;1647;46;2416;2370;561;386;579;2069;1508
2013;2014;14;SC Freiburg;34;36;-18;43;61;9;9;16;36;27;Freiburg im Breisgau;47.9990∘N;7.8421∘O;510;591;-171;646;817;159;124;227;601;442
2013;2014;15;VfB Stuttgart;34;32;-13;49;62;8;8;18;32;24;Stuttgart;48.7833∘N;9.1833∘O;1662;2082;422;2809;2387;700;406;556;2506;1806
2013;2014;16;Hamburger SV;34;27;-24;51;75;7;6;21;27;20;Hamburg;53.5511∘N;9.9937∘O;1730;2135;358;2810;2452;708;464;558;2588;1880
2013;2014;17;1. FC Nürnberg;34;26;-33;37;70;5;11;18;26;21;Nürnberg;49.4521∘N;11.0767∘O;1084;1072;-324;1402;1726;341;276;467;1299;958
2013;2014;18;Eintracht Braunschweig;34;25;-31;29;60;6;7;21;25;19;Braunschweig;52.2667∘N;10.5167∘O;706;667;-149;937;1086;242;177;287;903;661
2014;2015;1;Bayern München;34;79;62;80;18;25;4;5;79;54;München;48.1372∘N;11.5755∘O;1704;2817;1782;3684;1902;990;385;329;3355;2365
2014;2015;2;VfL Wolfsburg;34;69;34;72;38;20;9;5;69;49;Wolfsburg;52.4237∘N;10.7865∘O;612;870;46;948;902;239;153;220;870;631
2014;2015;3;Bor. Mönchengladbach;34;66;27;53;26;19;9;6;66;47;Mönchengladbach;51.1965∘N;6.4385∘O;1602;1918;404;2732;2328;643;429;530;2358;1715
2014;2015;4;Bayer Leverkusen;34;61;25;62;37;17;10;7;61;44;Leverkusen;51.0416∘N;7.0004∘O;1228;1728;418;2055;1637;521;345;362;1908;1387
2014;2015;5;FC Augsburg;34;49;0;43;43;15;4;15;49;34;Augsburg;48.3705∘N;10.8977∘O;136;172;-31;159;190;46;34;56;172;126
2014;2015;6;Schalke 04;34;48;2;42;40;13;9;12;48;35;Gelsenkirchen;51.5167∘N;7.0500∘O;1594;1971;76;2358;2282;629;399;566;2286;1657
2014;2015;7;Borussia Dortmund;34;46;5;47;42;13;7;14;46;33;Dortmund;51.5136∘N;7.4653∘O;1628;2172;512;2833;2321;704;421;503;2533;1829
2014;2015;8;TSG Hoffenheim;34;44;-6;49;55;12;8;14;44;32;Sinsheim;49.2500∘N;8.8833∘O;238;300;-19;361;380;78;66;94;300;222
2014;2015;9;Eintracht Frankfurt;34;43;-6;56;62;11;10;13;43;32;Frankfurt am Main;50.1109∘N;8.6821∘O;1560;1690;40;2472;2432;572;396;592;2112;1540
2014;2015;10;Werder Bremen;34;43;-15;50;65;11;10;13;43;32;Bremen;53.0736∘N;8.8064∘O;1730;2217;435;2926;2491;738;432;560;2646;1908
2014;2015;11;1. FSV Mainz 05;34;40;-2;45;47;9;13;12;40;31;Mainz;50.0000∘N;8.2711∘O;306;394;-32;404;436;103;85;118;394;291
2014;2015;12;1. FC Köln;34;40;-6;34;40;9;13;12;40;31;Köln;50.9333∘N;6.9500∘O;1492;1703;283;2493;2210;602;374;516;2180;1578
2014;2015;13;Hannover 96;34;37;-16;40;56;9;10;15;37;28;Hannover;52.3759∘N;9.7320∘O;914;953;-268;1279;1547;286;231;397;1089;803
2014;2015;14;VfB Stuttgart;34;36;-18;42;60;9;9;16;36;27;Stuttgart;48.7833∘N;9.1833∘O;1696;2118;404;2851;2447;709;415;572;2542;1833
2014;2015;15;Hertha BSC Berlin;34;35;-16;36;52;9;8;17;35;26;Berlin;52.5200∘N;13.4050∘O;1080;1262;-117;1542;1659;392;272;416;1448;1056
2014;2015;16;Hamburger SV;34;35;-25;25;50;9;8;17;35;26;Hamburg;53.5511∘N;9.9937∘O;1764;2170;333;2835;2502;717;472;575;2623;1906
2014;2015;17;SC Freiburg;34;34;-11;36;47;7;13;14;34;27;Freiburg im Breisgau;47.9990∘N;7.8421∘O;544;625;-182;682;864;166;137;241;635;469
2014;2015;18;SC Paderborn;34;31;-34;31;65;7;10;17;31;24;Paderborn;51.7144∘N;8.7528∘O;34;31;-34;31;65;7;10;17;31;24
2015;2016;1;Bayern München;34;88;63;80;17;28;4;2;88;60;München;48.1372∘N;11.5755∘O;1738;2905;1845;3764;1919;1018;389;331;3443;2425
2015;2016;2;Borussia Dortmund;34;78;48;82;34;24;6;4;78;54;Dortmund;51.5136∘N;7.4653∘O;1662;2250;560;2915;2355;728;427;507;2611;1883
2015;2016;3;Bayer Leverkusen;34;60;16;56;40;18;6;10;60;42;Leverkusen;51.0416∘N;7.0004∘O;1262;1788;434;2111;1677;539;351;372;1968;1429
2015;2016;4;Bor. Mönchengladbach;34;55;17;67;50;17;4;13;55;38;Mönchengladbach;51.1965∘N;6.4385∘O;1636;1973;421;2799;2378;660;433;543;2413;1753
2015;2016;5;Schalke 04;34;52;2;51;49;15;7;12;52;37;Gelsenkirchen;51.5167∘N;7.0500∘O;1628;2023;78;2409;2331;644;406;578;2338;1694
2015;2016;6;1. FSV Mainz 05;34;50;4;46;42;14;8;12;50;36;Mainz;50.0000∘N;8.2711∘O;340;444;-28;450;478;117;93;130;444;327
2015;2016;7;Hertha BSC Berlin;34;50;0;42;42;14;8;12;50;36;Berlin;52.5200∘N;13.4050∘O;1114;1312;-117;1584;1701;406;280;428;1498;1092
2015;2016;8;VfL Wolfsburg;34;45;-2;47;49;12;9;13;45;33;Wolfsburg;52.4237∘N;10.7865∘O;646;915;44;995;951;251;162;233;915;664
2015;2016;9;1. FC Köln;34;43;-4;38;42;10;13;11;43;33;Köln;50.9333∘N;6.9500∘O;1526;1746;279;2531;2252;612;387;527;2223;1611
2015;2016;10;Hamburger SV;34;41;-6;40;46;11;8;15;41;30;Hamburg;53.5511∘N;9.9937∘O;1798;2211;327;2875;2548;728;480;590;2664;1936
2015;2016;11;FC Ingolstadt;34;40;-9;33;42;10;10;14;40;30;Ingolstadt;48.7667∘N;11.4333∘O;34;40;-9;33;42;10;10;14;40;30
2015;2016;12;FC Augsburg;34;38;-10;42;52;9;11;14;38;29;Augsburg;48.3705∘N;10.8977∘O;170;210;-41;201;242;55;45;70;210;155
2015;2016;13;Werder Bremen;34;38;-15;50;65;10;8;16;38;28;Bremen;53.0736∘N;8.8064∘O;1764;2255;420;2976;2556;748;440;576;2684;1936
2015;2016;14;Darmstadt 98;34;38;-15;38;53;9;11;14;38;29;Darmstadt;49.8728∘N;8.6517∘O;102;80;-86;124;210;21;29;52;92;71
2015;2016;15;TSG Hoffenheim;34;37;-15;39;54;9;10;15;37;28;Sinsheim;49.2500∘N;8.8833∘O;272;337;-34;400;434;87;76;109;337;250
2015;2016;16;Eintracht Frankfurt;34;36;-18;34;52;9;9;16;36;27;Frankfurt am Main;50.1109∘N;8.6821∘O;1594;1726;22;2506;2484;581;405;608;2148;1567
2015;2016;17;VfB Stuttgart;34;33;-25;50;75;9;6;19;33;24;Stuttgart;48.7833∘N;9.1833∘O;1730;2151;379;2901;2522;718;421;591;2575;1857
2015;2016;18;Hannover 96;34;25;-31;31;62;7;4;23;25;18;Hannover;52.3759∘N;9.7320∘O;948;978;-299;1310;1609;293;235;420;1114;821
2016;2017;1;Bayern München;34;82;67;89;22;25;7;2;82;57;München;48.1372∘N;11.5755∘O;1772;2987;1912;3853;1941;1043;396;333;3525;2482
2016;2017;2;RB Leipzig;34;67;27;66;39;20;7;7;67;47;Leipzig;51.3397∘N;12.3731∘O;34;67;27;66;39;20;7;7;67;47
2016;2017;3;Borussia Dortmund;34;64;32;72;40;18;10;6;64;46;Dortmund;51.5136∘N;7.4653∘O;1696;2314;592;2987;2395;746;437;513;2675;1929
2016;2017;4;TSG Hoffenheim;34;62;27;64;37;16;14;4;62;46;Sinsheim;49.2500∘N;8.8833∘O;306;399;-7;464;471;103;90;113;399;296
2016;2017;5;1. FC Köln;34;49;9;51;42;12;13;9;49;37;Köln;50.9333∘N;6.9500∘O;1560;1795;288;2582;2294;624;400;536;2272;1648
2016;2017;6;Hertha BSC Berlin;34;49;-4;43;47;15;4;15;49;34;Berlin;52.5200∘N;13.4050∘O;1148;1361;-121;1627;1748;421;284;443;1547;1126
2016;2017;7;SC Freiburg;34;48;-18;42;60;14;6;14;48;34;Freiburg im Breisgau;47.9990∘N;7.8421∘O;578;673;-200;724;924;180;143;255;683;503
2016;2017;8;Werder Bremen;34;45;-3;61;64;13;6;15;45;32;Bremen;53.0736∘N;8.8064∘O;1798;2300;417;3037;2620;761;446;591;2729;1968
2016;2017;9;Bor. Mönchengladbach;34;45;-4;45;49;12;9;13;45;33;Mönchengladbach;51.1965∘N;6.4385∘O;1670;2018;417;2844;2427;672;442;556;2458;1786
2016;2017;10;Schalke 04;34;43;5;45;40;11;10;13;43;32;Gelsenkirchen;51.5167∘N;7.0500∘O;1662;2066;83;2454;2371;655;416;591;2381;1726
2016;2017;11;Eintracht Frankfurt;34;42;-7;36;43;11;9;14;42;31;Frankfurt am Main;50.1109∘N;8.6821∘O;1628;1768;15;2542;2527;592;414;622;2190;1598
2016;2017;12;Bayer Leverkusen;34;41;-2;53;55;11;8;15;41;30;Leverkusen;51.0416∘N;7.0004∘O;1296;1829;432;2164;1732;550;359;387;2009;1459
2016;2017;13;FC Augsburg;34;38;-16;35;51;9;11;14;38;29;Augsburg;48.3705∘N;10.8977∘O;204;248;-57;236;293;64;56;84;248;184
2016;2017;14;Hamburger SV;34;38;-28;33;61;10;8;16;38;28;Hamburg;53.5511∘N;9.9937∘O;1832;2249;299;2908;2609;738;488;606;2702;1964
2016;2017;15;1. FSV Mainz 05;34;37;-11;44;55;10;7;17;37;27;Mainz;50.0000∘N;8.2711∘O;374;481;-39;494;533;127;100;147;481;354
2016;2017;16;VfL Wolfsburg;34;37;-18;34;52;10;7;17;37;27;Wolfsburg;52.4237∘N;10.7865∘O;680;952;26;1029;1003;261;169;250;952;691
2016;2017;17;FC Ingolstadt;34;32;-21;36;57;8;8;18;32;24;Ingolstadt;48.7667∘N;11.4333∘O;68;72;-30;69;99;18;18;32;72;54
2016;2017;18;Darmstadt 98;34;25;-35;28;63;7;4;23;25;18;Darmstadt;49.8728∘N;8.6517∘O;136;105;-121;152;273;28;33;75;117;89
2017;2018;1;Bayern München;34;84;64;92;28;27;3;4;84;57;München;48.1372∘N;11.5755∘O;1806;3071;1976;3945;1969;1070;399;337;3609;2539
2017;2018;2;Schalke 04;34;63;16;53;37;18;9;7;63;45;Gelsenkirchen;51.5167∘N;7.0500∘O;1696;2129;99;2507;2408;673;425;598;2444;1771
2017;2018;3;TSG Hoffenheim;34;55;18;66;48;15;10;9;55;40;Sinsheim;49.2500∘N;8.8833∘O;340;454;11;530;519;118;100;122;454;336
2017;2018;4;Borussia Dortmund;34;55;17;64;47;15;10;9;55;40;Dortmund;51.5136∘N;7.4653∘O;1730;2369;609;3051;2442;761;447;522;2730;1969
2017;2018;5;Bayer Leverkusen;34;55;14;58;44;15;10;9;55;40;Leverkusen;51.0416∘N;7.0004∘O;1330;1884;446;2222;1776;565;369;396;2064;1499
2017;2018;6;RB Leipzig;34;53;4;57;53;15;8;11;53;38;Leipzig;51.3397∘N;12.3731∘O;68;120;31;123;92;35;15;18;120;85
2017;2018;7;VFB Stuttgart;34;51;0;36;36;15;6;13;51;36;Stuttgart;48.7833∘N;9.1833∘O;1764;2202;379;2937;2558;733;427;604;2626;1893
2017;2018;8;Eintracht Frankfurt;34;49;0;45;45;14;7;13;49;35;Frankfurt am Main;50.1109∘N;8.6821∘O;1662;1817;15;2587;2572;606;421;635;2239;1633
2017;2018;9;Bor. Mönchengladbach;34;47;-5;47;52;13;8;13;47;34;Mönchengladbach;51.1965∘N;6.4385∘O;1704;2065;412;2891;2479;685;450;569;2505;1820
2017;2018;10;Hertha BSC Berlin;34;43;-3;43;46;10;13;11;43;33;Berlin;52.5200∘N;13.4050∘O;1182;1404;-124;1670;1794;431;297;454;1590;1159
2017;2018;11;Werder Bremen;34;42;-3;37;40;10;12;12;42;32;Bremen;53.0736∘N;8.8064∘O;1832;2342;414;3074;2660;771;458;603;2771;2000
2017;2018;12;FC Augsburg;34;41;-3;43;46;10;11;13;41;31;Augsburg;48.3705∘N;10.8977∘O;238;289;-60;279;339;74;67;97;289;215
2017;2018;13;Hannover 96;34;39;-10;44;54;10;9;15;39;29;Hannover;52.3759∘N;9.7320∘O;982;1017;-309;1354;1663;303;244;435;1153;850
2017;2018;14;1. FSV Mainz 05;34;36;-14;38;52;9;9;16;36;27;Mainz;50.0000∘N;8.2711∘O;408;517;-53;532;585;136;109;163;517;381
2017;2018;15;SC Freiburg;34;36;-24;32;56;8;12;14;36;28;Freiburg im Breisgau;47.9990∘N;7.8421∘O;612;709;-224;756;980;188;155;269;719;531
2017;2018;16;VfL Wolfsburg;34;33;-12;36;48;6;15;13;33;27;Wolfsburg;52.4237∘N;10.7865∘O;714;985;14;1065;1051;267;184;263;985;718
2017;2018;17;Hamburger SV;34;31;-24;29;53;8;7;19;31;23;Hamburg;53.5511∘N;9.9937∘O;1866;2280;275;2937;2662;746;495;625;2733;1987
2017;2018;18;1. FC Köln;34;22;-35;35;70;5;7;22;22;17;Köln;50.9333∘N;6.9500∘O;1594;1817;253;2617;2364;629;407;558;2294;1665
2018;2019;1;Bayern München;34;78;56;88;32;24;6;4;78;54;München;48.1372∘N;11.5755∘O;1840;3149;2032;4033;2001;1094;405;341;3687;2593
2018;2019;2;Borussia Dortmund;34;76;37;81;44;23;7;4;76;53;Dortmund;51.5136∘N;7.4653∘O;1764;2445;646;3132;2486;784;454;526;2806;2022
2018;2019;3;RB Leipzig;34;66;34;63;29;19;9;6;66;47;Leipzig;51.3397∘N;12.3731∘O;102;186;65;186;121;54;24;24;186;132
2018;2019;4;Bayer Leverkusen;34;58;17;69;52;18;4;12;58;40;Leverkusen;51.0416∘N;7.0004∘O;1364;1942;463;2291;1828;583;373;408;2122;1539
2018;2019;5;Bor. Mönchengladbach;34;55;13;55;42;16;7;11;55;39;Mönchengladbach;51.1965∘N;6.4385∘O;1738;2120;425;2946;2521;701;457;580;2560;1859
2018;2019;6;VfL Wolfsburg;34;55;12;62;50;16;7;11;55;39;Wolfsburg;52.4237∘N;10.7865∘O;748;1040;26;1127;1101;283;191;274;1040;757
2018;2019;7;Eintracht Frankfurt;34;54;12;60;48;15;9;10;54;39;Frankfurt am Main;50.1109∘N;8.6821∘O;1696;1871;27;2647;2620;621;430;645;2293;1672
2018;2019;8;Werder Bremen;34;53;9;58;49;14;11;9;53;39;Bremen;53.0736∘N;8.8064∘O;1866;2395;423;3132;2709;785;469;612;2824;2039
2018;2019;9;TSG Hoffenheim;34;51;18;70;52;13;12;9;51;38;Sinsheim;49.2500∘N;8.8833∘O;374;505;29;600;571;131;112;131;505;374
2018;2019;10;Fortuna Düsseldorf;34;44;-16;49;65;13;5;16;44;31;Düsseldorf;51.2217∘N;6.7761∘O;820;773;-242;1209;1451;258;220;342;994;736
2018;2019;11;Hertha BSC Berlin;34;43;-8;49;57;11;10;13;43;32;Berlin;52.5200∘N;13.4050∘O;1216;1447;-132;1719;1851;442;307;467;1633;1191
2018;2019;12;1. FSV Mainz 05;34;43;-11;46;57;12;7;15;43;31;Mainz;50.0000∘N;8.2711∘O;442;560;-64;578;642;148;116;178;560;412
2018;2019;13;SC Freiburg;34;36;-15;46;61;8;12;14;36;28;Freiburg im Breisgau;47.9990∘N;7.8421∘O;646;745;-239;802;1041;196;167;283;755;559
2018;2019;14;Schalke 04;34;33;-18;37;55;8;9;17;33;25;Gelsenkirchen;51.5167∘N;7.0500∘O;1730;2162;81;2544;2463;681;434;615;2477;1796
2018;2019;15;FC Augsburg;34;32;-20;51;71;8;8;18;32;24;Augsburg;48.3705∘N;10.8977∘O;272;321;-80;330;410;82;75;115;321;239
2018;2019;16;VFB Stuttgart;34;28;-38;32;70;7;7;20;28;21;Stuttgart;48.7833∘N;9.1833∘O;1798;2230;341;2969;2628;740;434;624;2654;1914
2018;2019;17;Hannover 96;34;21;-40;31;71;5;6;23;21;16;Hannover;52.3759∘N;9.7320∘O;1016;1038;-349;1385;1734;308;250;458;1174;866
2018;2019;18;1. FC Nürnberg;34;19;-42;26;68;3;10;21;19;16;Nürnberg;49.4521∘N;11.0767∘O;1118;1091;-366;1428;1794;344;286;488;1318;974
2019;2020;1;Bayern München;34;82;68;100;32;26;4;4;82;56;München;48.1372∘N;11.5755∘O;1874;3231;2100;4133;2033;1120;409;345;3769;2649
2019;2020;2;Borussia Dortmund;34;69;43;84;41;21;6;7;69;48;Dortmund;51.5136∘N;7.4653∘O;1798;2514;689;3216;2527;805;460;533;2875;2070
2019;2020;3;RB Leipzig;34;66;44;81;37;18;12;4;66;48;Leipzig;51.3397∘N;12.3731∘O;136;252;109;267;158;72;36;28;252;180
2019;2020;4;Bor. Mönchengladbach;34;65;26;66;40;20;5;9;65;45;Mönchengladbach;51.1965∘N;6.4385∘O;1772;2185;451;3012;2561;721;462;589;2625;1904
2019;2020;5;Bayer Leverkusen;34;63;17;61;44;19;6;9;63;44;Leverkusen;51.0416∘N;7.0004∘O;1398;2005;480;2352;1872;602;379;417;2185;1583
2019;2020;6;TSG Hoffenheim;34;52;0;53;53;15;7;12;52;37;Sinsheim;49.2500∘N;8.8833∘O;408;557;29;653;624;146;119;143;557;411
2019;2020;7;VfL Wolfsburg;34;49;2;48;46;13;10;11;49;36;Wolfsburg;52.4237∘N;10.7865∘O;782;1089;28;1175;1147;296;201;285;1089;793
2019;2020;8;SC Freiburg;34;48;1;48;47;13;9;12;48;35;Freiburg im Breisgau;47.9990∘N;7.8421∘O;680;793;-238;850;1088;209;176;295;803;594
2019;2020;9;Eintracht Frankfurt;34;45;-1;59;60;13;6;15;45;32;Frankfurt am Main;50.1109∘N;8.6821∘O;1730;1916;26;2706;2680;634;436;660;2338;1704
2019;2020;10;Hertha BSC Berlin;34;41;-11;48;59;11;8;15;41;30;Berlin;52.5200∘N;13.4050∘O;1250;1488;-143;1767;1910;453;315;482;1674;1221
2019;2020;11;Union Berlin;34;41;-17;41;58;12;5;17;41;29;Berlin;52.5200∘N;13.4050∘O;34;41;-17;41;58;12;5;17;41;29
2019;2020;12;Schalke 04;34;39;-20;38;58;9;12;13;39;30;Gelsenkirchen;51.5167∘N;7.0500∘O;1764;2201;61;2582;2521;690;446;628;2516;1826
2019;2020;13;1. FSV Mainz 05;34;37;-21;44;65;11;4;19;37;26;Mainz;50.0000∘N;8.2711∘O;476;597;-85;622;707;159;120;197;597;438
2019;2020;14;1. FC Köln;34;36;-18;51;69;10;6;18;36;26;Köln;50.9333∘N;6.9500∘O;1628;1853;235;2668;2433;639;413;576;2330;1691
2019;2020;15;FC Augsburg;34;36;-18;45;63;9;9;16;36;27;Augsburg;48.3705∘N;10.8977∘O;306;357;-98;375;473;91;84;131;357;266
2019;2020;16;Werder Bremen;34;31;-27;42;69;8;7;19;31;23;Bremen;53.0736∘N;8.8064∘O;1900;2426;396;3174;2778;793;476;631;2855;2062
2019;2020;17;Fortuna Düsseldorf;34;30;-31;36;67;6;12;16;30;24;Düsseldorf;51.2217∘N;6.7761∘O;854;803;-273;1245;1518;264;232;358;1024;760
2019;2020;18;SC Paderborn;34;20;-37;37;74;4;8;22;20;16;Paderborn;51.7144∘N;8.7528∘O;68;51;-71;68;139;11;18;39;51;40
2020;2021;1;Bayern München;34;78;55;99;44;24;6;4;78;54;München;48.1372∘N;11.5755∘O;1908;3309;2155;4232;2077;1144;415;349;3847;2703
2020;2021;2;RB Leipzig;34;65;28;60;32;19;8;7;65;46;Leipzig;51.3397∘N;12.3731∘O;170;317;137;327;190;91;44;35;317;226
2020;2021;3;Borussia Dortmund;34;64;29;75;46;20;4;10;64;44;Dortmund;51.5136∘N;7.4653∘O;1832;2578;718;3291;2573;825;464;543;2939;2114
2020;2021;4;VfL Wolfsburg;34;61;24;61;37;17;10;7;61;44;Wolfsburg;52.4237∘N;10.7865∘O;816;1150;52;1236;1184;313;211;292;1150;837
2020;2021;5;Eintracht Frankfurt;34;60;16;69;53;16;12;6;60;44;Frankfurt am Main;50.1109∘N;8.6821∘O;1764;1976;42;2775;2733;650;448;666;2398;1748
2020;2021;6;Bayer Leverkusen;34;52;14;53;39;14;10;10;52;38;Leverkusen;51.0416∘N;7.0004∘O;1432;2057;494;2405;1911;616;389;427;2237;1621
2020;2021;7;Union Berlin;34;50;7;50;43;12;14;8;50;38;Berlin;52.5200∘N;13.4050∘O;68;91;-10;91;101;24;19;25;91;67
2020;2021;8;Bor. Mönchengladbach;34;49;8;64;56;13;10;11;49;36;Mönchengladbach;51.1965∘N;6.4385∘O;1806;2234;459;3076;2617;734;472;600;2674;1940
2020;2021;9;VFB Stuttgart;34;45;1;56;55;12;9;13;45;33;Stuttgart;48.7833∘N;9.1833∘O;1832;2275;342;3025;2683;752;443;637;2699;1947
2020;2021;10;SC Freiburg;34;45;0;52;52;12;9;13;45;33;Freiburg im Breisgau;47.9990∘N;7.8421∘O;714;838;-238;902;1140;221;185;308;848;627
2020;2021;11;TSG Hoffenheim;34;43;-2;52;54;11;10;13;43;32;Sinsheim;49.2500∘N;8.8833∘O;442;600;27;705;678;157;129;156;600;443
2020;2021;12;1. FSV Mainz 05;34;39;-17;39;56;10;9;15;39;29;Mainz;50.0000∘N;8.2711∘O;510;636;-102;661;763;169;129;212;636;467
2020;2021;13;FC Augsburg;34;36;-18;36;54;10;6;18;36;26;Augsburg;48.3705∘N;10.8977∘O;340;393;-116;411;527;101;90;149;393;292
2020;2021;14;Hertha BSC Berlin;34;35;-11;41;52;8;11;15;35;27;Berlin;52.5200∘N;13.4050∘O;1284;1523;-154;1808;1962;461;326;497;1709;1248
2020;2021;15;Arminia Bielefeld;34;35;-26;26;52;9;8;17;35;26;Bielefeld;52.0211∘N;8.5342∘O;612;558;-298;712;1010;162;147;290;633;471
2020;2021;16;1. FC Köln;34;33;-26;34;60;8;9;17;33;25;Köln;50.9333∘N;6.9500∘O;1662;1886;209;2702;2493;647;422;593;2363;1716
2020;2021;17;Werder Bremen;34;31;-21;36;57;7;10;17;31;24;Bremen;53.0736∘N;8.8064∘O;1934;2457;375;3210;2835;800;486;648;2886;2086
2020;2021;18;Schalke 04;34;16;-61;25;86;3;7;24;16;13;Gelsenkirchen;51.5167∘N;7.0500∘O;1798;2217;0;2607;2607;693;453;652;2532;1839
2021;2022;1;Bayern München;34;77;60;97;37;24;5;5;77;53;München;48.1372∘N;11.5755∘O;1942;3386;2215;4329;2114;1168;420;354;3924;2756
2021;2022;2;Borussia Dortmund;34;69;33;85;52;22;3;9;69;47;Dortmund;51.5136∘N;7.4653∘O;1866;2647;751;3376;2625;847;467;552;3008;2161
2021;2022;3;Bayer Leverkusen;34;64;33;80;47;19;7;8;64;45;Leverkusen;51.0416∘N;7.0004∘O;1466;2121;527;2485;1958;635;396;435;2301;1666
2021;2022;4;RB Leipzig;34;58;35;72;37;17;7;10;58;41;Leipzig;51.3397∘N;12.3731∘O;204;375;172;399;227;108;51;45;375;267
2021;2022;5;Union Berlin;34;57;6;50;44;16;9;9;57;41;Berlin;52.5200∘N;13.4050∘O;102;148;-4;141;145;40;28;34;148;108
2021;2022;6;SC Freiburg;34;55;12;58;46;15;10;9;55;40;Freiburg im Breisgau;47.9990∘N;7.8421∘O;748;893;-226;960;1186;236;195;317;903;667
2021;2022;7;1. FC Köln;34;52;3;52;49;14;10;10;52;38;Köln;50.9333∘N;6.9500∘O;1696;1938;212;2754;2542;661;432;603;2415;1754
2021;2022;8;1. FSV Mainz 05;34;46;5;50;45;13;7;14;46;33;Mainz;50.0000∘N;8.2711∘O;544;682;-97;711;808;182;136;226;682;500
2021;2022;9;TSG Hoffenheim;34;46;-2;58;60;13;7;14;46;33;Sinsheim;49.2500∘N;8.8833∘O;476;646;25;763;738;170;136;170;646;476
2021;2022;10;Bor. Mönchengladbach;34;45;-7;54;61;12;9;13;45;33;Mönchengladbach;51.1965∘N;6.4385∘O;1840;2279;452;3130;2678;746;481;613;2719;1973
2021;2022;11;Eintracht Frankfurt;34;42;-4;45;49;10;12;12;42;32;Frankfurt am Main;50.1109∘N;8.6821∘O;1798;2018;38;2820;2782;660;460;678;2440;1780
2021;2022;12;VFL Wolfsburg;34;42;-11;43;54;12;6;16;42;30;Wolfsburg;52.4237∘N;10.7865∘O;850;1192;41;1279;1238;325;217;308;1192;867
2021;2022;13;VFL Bochum;34;42;-14;38;52;12;6;16;42;30;Bochum;51.4818∘N;7.2163∘O;1194;1180;-299;1640;1939;368;312;514;1416;1048
2021;2022;14;FC Augsburg;34;38;-17;39;56;10;8;16;38;28;Augsburg;48.3705∘N;10.8977∘O;374;431;-133;450;583;111;98;165;431;320
2021;2022;15;VFB Stuttgart;34;33;-18;41;59;7;12;15;33;26;Stuttgart;48.7833∘N;9.1833∘O;1866;2308;324;3066;2742;759;455;652;2732;1973
2021;2022;16;Hertha BSC Berlin;34;33;-34;37;71;9;6;19;33;24;Berlin;52.5200∘N;13.4050∘O;1318;1556;-188;1845;2033;470;332;516;1742;1272
2021;2022;17;Arminia Bielefeld;34;28;-26;27;53;5;13;16;28;23;Bielefeld;52.0211∘N;8.5342∘O;646;586;-324;739;1063;167;160;306;661;494
2021;2022;18;SpVgg Greuther Fürth;34;18;-54;28;82;3;9;22;18;15;Fürth;49.4776∘N;10.9854∘O;68;39;-88;54;142;7;18;43;39;32
2022;2023;1;Bayern München;34;71;54;92;38;21;8;5;71;50;München;48.1372∘N;11.5755∘O;1976;3457;2269;4421;2152;1189;428;359;3995;2806
2022;2023;2;Borussia Dortmund;34;71;39;83;44;22;5;7;71;49;Dortmund;51.5136∘N;7.4653∘O;1900;2718;790;3459;2669;869;472;559;3079;2210
2022;2023;3;RB Leipzig;34;66;23;64;41;20;6;8;66;46;Leipzig;51.3397∘N;12.3731∘O;238;441;195;463;268;128;57;53;441;313
2022;2023;4;Union Berlin;34;62;13;51;38;18;8;8;62;44;Berlin;52.5200∘N;13.4050∘O;136;210;9;192;183;58;36;42;210;152
2022;2023;5;SC Freiburg;34;59;7;51;44;17;8;9;59;42;Freiburg im Breisgau;47.9990∘N;7.8421∘O;782;952;-219;1011;1230;253;203;326;962;709
2022;2023;6;Bayer Leverkusen;34;50;8;57;49;14;8;12;50;36;Leverkusen;51.0416∘N;7.0004∘O;1500;2171;535;2542;2007;649;404;447;2351;1702
2022;2023;7;Eintracht Frankfurt;34;50;6;58;52;13;11;10;50;37;Frankfurt am Main;50.1109∘N;8.6821∘O;1832;2068;44;2878;2834;673;471;688;2490;1817
2022;2023;8;VFL Wolfsburg;34;49;9;57;48;13;10;11;49;36;Wolfsburg;52.4237∘N;10.7865∘O;884;1241;50;1336;1286;338;227;319;1241;903
2022;2023;9;1. FSV Mainz 05;34;46;-1;54;55;12;10;12;46;34;Mainz;50.0000∘N;8.2711∘O;578;728;-98;765;863;194;146;238;728;534
2022;2023;10;Bor. Mönchengladbach;34;43;-3;52;55;11;10;13;43;32;Mönchengladbach;51.1965∘N;6.4385∘O;1874;2322;449;3182;2733;757;491;626;2762;2005
2022;2023;11;1. FC Köln;34;42;-5;49;54;10;12;12;42;32;Köln;50.9333∘N;6.9500∘O;1730;1980;207;2803;2596;671;444;615;2457;1786
2022;2023;12;TSG Hoffenheim;34;36;-9;48;57;10;6;18;36;26;Sinsheim;49.2500∘N;8.8833∘O;510;682;16;811;795;180;142;188;682;502
2022;2023;13;Werder Bremen;34;36;-13;51;64;10;6;18;36;26;Bremen;53.0736∘N;8.8064∘O;1968;2493;362;3261;2899;810;492;666;2922;2112
2022;2023;14;VFL Bochum;34;35;-32;40;72;10;5;19;35;25;Bochum;51.4818∘N;7.2163∘O;1228;1215;-331;1680;2011;378;317;533;1451;1073
2022;2023;15;FC Augsburg;34;34;-21;42;63;9;7;18;34;25;Augsburg;48.3705∘N;10.8977∘O;408;465;-154;492;646;120;105;183;465;345
2022;2023;16;VFB Stuttgart;34;33;-12;45;57;7;12;15;33;26;Stuttgart;48.7833∘N;9.1833∘O;1900;2341;312;3111;2799;766;467;667;2765;1999
2022;2023;17;Schalke 04;34;31;-36;35;71;7;10;17;31;24;Gelsenkirchen;51.5167∘N;7.0500∘O;1832;2248;-36;2642;2678;700;463;669;2563;1863
2022;2023;18;Hertha BSC Berlin;34;29;-27;42;69;7;8;19;29;22;Berlin;52.5200∘N;13.4050∘O;1352;1585;-215;1887;2102;477;340;535;1771;1294
2023;2024;1;Bayer Leverkusen;34;90;65;89;24;28;6;0;90;62;Leverkusen;51.0416∘N;7.0004∘O;1534;2261;600;2631;2031;677;410;447;2441;1764
2023;2024;2;VFB Stuttgart;34;73;39;78;39;23;4;7;73;50;Stuttgart;48.7833∘N;9.1833∘O;1934;2414;351;3189;2838;789;471;674;2838;2049
2023;2024;3;Bayern München;34;72;49;94;45;23;3;8;72;49;München;48.1372∘N;11.5755∘O;2010;3529;2318;4515;2197;1212;431;367;4067;2855
2023;2024;4;RB Leipzig;34;65;38;77;39;19;8;7;65;46;Leipzig;51.3397∘N;12.3731∘O;272;506;233;540;307;147;65;60;506;359
2023;2024;5;Borussia Dortmund;34;63;25;68;43;18;9;7;63;45;Dortmund;51.5136∘N;7.4653∘O;1934;2781;815;3527;2712;887;481;566;3142;2255
2023;2024;6;Eintracht Frankfurt;34;47;1;51;50;11;14;9;47;36;Frankfurt am Main;50.1109∘N;8.6821∘O;1866;2115;45;2929;2884;684;485;697;2537;1853
2023;2024;7;TSG Hoffenheim;34;46;0;66;66;13;7;14;46;33;Sinsheim;49.2500∘N;8.8833∘O;544;728;16;877;861;193;149;202;728;535
2023;2024;8;FC Heidenheim;34;42;-5;50;55;10;12;12;42;32;Heidenheim an der Brenz;48.6833∘N;10.1500∘O;34;42;-5;50;55;10;12;12;42;32
2023;2024;9;Werder Bremen;34;42;-6;48;54;11;9;14;42;31;Bremen;53.0736∘N;8.8064∘O;2002;2535;356;3309;2953;821;501;680;2964;2143
2023;2024;10;SC Freiburg;34;42;-13;45;58;11;9;14;42;31;Freiburg im Breisgau;47.9990∘N;7.8421∘O;816;994;-232;1056;1288;264;212;340;1004;740
2023;2024;11;FC Augsburg;34;39;-10;50;60;10;9;15;39;29;Augsburg;48.3705∘N;10.8977∘O;442;504;-164;542;706;130;114;198;504;374
2023;2024;12;VFL Wolfsburg;34;37;-15;41;56;10;7;17;37;27;Wolfsburg;52.4237∘N;10.7865∘O;918;1278;35;1377;1342;348;234;336;1278;930
2023;2024;13;1. FSV Mainz 05;34;35;-12;39;51;7;14;13;35;28;Mainz;50.0000∘N;8.2711∘O;612;763;-110;804;914;201;160;251;763;562
2023;2024;14;Bor. Mönchengladbach;34;34;-11;56;67;7;13;14;34;27;Mönchengladbach;51.1965∘N;6.4385∘O;1908;2356;438;3238;2800;764;504;640;2796;2032
2023;2024;15;Union Berlin;34;33;-25;33;58;9;6;19;33;24;Berlin;52.5200∘N;13.4050∘O;170;243;-16;225;241;67;42;61;243;176
2023;2024;16;VFL Bochum;34;33;-32;42;74;7;12;15;33;26;Bochum;51.4818∘N;7.2163∘O;1262;1248;-363;1722;2085;385;329;548;1484;1099
2023;2024;17;1. FC Köln;34;27;-32;28;60;5;12;17;27;22;Köln;50.9333∘N;6.9500∘O;1764;2007;175;2831;2656;676;456;632;2484;1808
2023;2024;18;Darmstadt 98;34;17;-56;30;86;3;8;23;17;14;Darmstadt;49.8728∘N;8.6517∘O;170;122;-177;182;359;31;41;98;134;103
2024;2025;1;Bayern München;34;82;67;99;32;25;7;2;82;57;München;48.1372∘N;11.5755∘O;2044;3611;2385;4614;2229;1237;438;369;4149;2912
2024;2025;2;Bayer Leverkusen;34;69;29;72;43;19;12;3;69;50;Leverkusen;51.0416∘N;7.0004∘O;1568;2330;629;2703;2074;696;422;450;2510;1814
2024;2025;3;Eintracht Frankfurt;34;60;22;68;46;17;9;8;60;43;Frankfurt am Main;50.1109∘N;8.6821∘O;1900;2175;67;2997;2930;701;494;705;2597;1896
2024;2025;4;Borussia Dortmund;34;57;20;71;51;17;6;11;57;40;Dortmund;51.5136∘N;7.4653∘O;1968;2838;835;3598;2763;904;487;577;3199;2295
2024;2025;5;SC Freiburg;34;55;-4;49;53;16;7;11;55;39;Freiburg im Breisgau;47.9990∘N;7.8421∘O;850;1049;-236;1105;1341;280;219;351;1059;779
2024;2025;6;1. FSV Mainz 05;34;52;12;55;43;14;10;10;52;38;Mainz;50.0000∘N;8.2711∘O;646;815;-98;859;957;215;170;261;815;600
2024;2025;7;RB Leipzig;34;51;5;53;48;13;12;9;51;38;Leipzig;51.3397∘N;12.3731∘O;306;557;238;593;355;160;77;69;557;397
2024;2025;8;Werder Bremen;34;51;-3;54;57;14;9;11;51;37;Bremen;53.0736∘N;8.8064∘O;2036;2586;353;3363;3010;835;510;691;3015;2180
2024;2025;9;VFB Stuttgart;34;50;11;64;53;14;8;12;50;36;Stuttgart;48.7833∘N;9.1833∘O;1968;2464;362;3253;2891;803;479;686;2888;2085
2024;2025;10;Bor. Mönchengladbach;34;45;-2;55;57;13;6;15;45;32;Mönchengladbach;51.1965∘N;6.4385∘O;1942;2401;436;3293;2857;777;510;655;2841;2064
2024;2025;11;VFL Wolfsburg;34;43;2;56;54;11;10;13;43;32;Wolfsburg;52.4237∘N;10.7865∘O;952;1321;37;1433;1396;359;244;349;1321;962
2024;2025;12;FC Augsburg;34;43;-16;35;51;11;10;13;43;32;Augsburg;48.3705∘N;10.8977∘O;476;547;-180;577;757;141;124;211;547;406
2024;2025;13;Union Berlin;34;40;-16;35;51;10;10;14;40;30;Berlin;52.5200∘N;13.4050∘O;204;283;-32;260;292;77;52;75;283;206
2024;2025;14;FC St. Pauli;34;32;-13;28;41;8;8;18;32;24;Hamburg;53.5511∘N;9.9937∘O;306;256;-202;324;526;66;88;152;286;220
2024;2025;15;TSG Hoffenheim;34;32;-22;46;68;7;11;16;32;25;Sinsheim;49.2500∘N;8.8833∘O;578;760;-6;923;929;200;160;218;760;560
2024;2025;16;FC Heidenheim;34;29;-27;37;64;8;5;21;29;21;Heidenheim an der Brenz;48.6833∘N;10.1500∘O;68;71;-32;87;119;18;17;33;71;53
2024;2025;17;Holstein Kiel;34;25;-31;49;80;6;7;21;25;19;Kiel;54.3233∘N;10.1394∘O;34;25;-31;49;80;6;7;21;25;19
2024;2025;18;VFL Bochum;34;25;-34;33;67;6;7;21;25;19;Bochum;51.4818∘N;7.2163∘O;1296;1273;-397;1755;2152;391;336;569;1509;1118
